"SNo","business_name","date","transaction_no","remarks","account_number","credit","debit","closing_balance"
"1","TCCL1002 - KUMAR CABLE NETWORK ( TNTDNTCCL1002 ) ","2023-08-07 16:59:56","DDL1648454481","Deduction","C1448873","","68.23","3410.29"
"2","TCCL1002 - KUMAR CABLE NETWORK ( TNTDNTCCL1002 ) ","2023-08-07 16:59:56","DDL1648454486","Deduction","C1448873","","28.55","3381.74"
"3","TCCL1002 - KUMAR CABLE NETWORK ( TNTDNTCCL1002 ) ","2023-08-10 15:22:06","TR17921932","Adjustment (credit note for august-2023 life time stb ncf bill(1*35.40)) ","","35.40","","3417.14"
"4","TCCL1002 - KUMAR CABLE NETWORK ( TNTDNTCCL1002 ) ","2023-08-10 15:36:24","DDL1649261065","Deduction","C5714740","","35.40","3381.74"
"5","TCCL1002 - KUMAR CABLE NETWORK ( TNTDNTCCL1002 ) ","2023-08-15 11:30:00","DDL1651983139","Deduction","C2361951","","19.42","3362.32"
"6","TCCL1002 - KUMAR CABLE NETWORK ( TNTDNTCCL1002 ) ","2023-08-15 11:30:00","DDL1651983144","Deduction","C2361951","","46.41","3315.91"
"7","TCCL1002 - KUMAR CABLE NETWORK ( TNTDNTCCL1002 ) ","2023-08-15 11:30:00","DDL1651983149","Deduction","C2361951","","14.85","3301.06"
"8","TCCL1002 - KUMAR CABLE NETWORK ( TNTDNTCCL1002 ) ","2023-08-15 11:30:00","DDL1651983154","Deduction","C2361951","","35.48","3265.58"
"9","TCCL1002 - KUMAR CABLE NETWORK ( TNTDNTCCL1002 ) ","2023-08-15 19:24:08","DDL1652294847","Deduction","C1496001","","19.42","3246.16"
"10","TCCL1002 - KUMAR CABLE NETWORK ( TNTDNTCCL1002 ) ","2023-08-15 19:24:08","DDL1652294862","Deduction","C1496001","","46.41","3199.75"
"11","TCCL1002 - KUMAR CABLE NETWORK ( TNTDNTCCL1002 ) ","2023-08-15 19:24:08","DDL1652294867","Deduction","C1496001","","15.99","3183.76"
"12","TCCL1002 - KUMAR CABLE NETWORK ( TNTDNTCCL1002 ) ","2023-08-15 19:24:08","DDL1652294872","Deduction","C1496001","","38.21","3145.55"
"13","TCCL1002 - KUMAR CABLE NETWORK ( TNTDNTCCL1002 ) ","2023-08-15 19:26:20","DDL1652297146","Deduction","C1459352","","19.42","3126.13"
"14","TCCL1002 - KUMAR CABLE NETWORK ( TNTDNTCCL1002 ) ","2023-08-15 19:26:20","DDL1652297151","Deduction","C1459352","","46.41","3079.72"
"15","TCCL1002 - KUMAR CABLE NETWORK ( TNTDNTCCL1002 ) ","2023-08-16 16:14:45","DDL1652851415","Deduction","C0798097","","5.71","3074.01"
"16","TCCL1002 - KUMAR CABLE NETWORK ( TNTDNTCCL1002 ) ","2023-08-16 16:14:45","DDL1652851420","Deduction","C0798097","","13.65","3060.36"
"17","TCCL1002 - KUMAR CABLE NETWORK ( TNTDNTCCL1002 ) ","2023-08-16 16:14:45","DDL1652851425","Deduction","C0798097","","17.13","3043.23"
"18","TCCL1002 - KUMAR CABLE NETWORK ( TNTDNTCCL1002 ) ","2023-08-16 16:14:45","DDL1652851430","Deduction","C0798097","","40.94","3002.29"
"19","TCCL1002 - KUMAR CABLE NETWORK ( TNTDNTCCL1002 ) ","2023-08-18 12:29:33","TR18028608","Normal Deposit (Lco Amount Deposited from Lco Portal. Paytm payment with Ref No- RC_f27TRB) ","","10000.00","","13002.29"
"20","TCCL1002 - KUMAR CABLE NETWORK ( TNTDNTCCL1002 ) ","2023-08-20 16:57:50","TR18060833","Normal Deposit (Lco Amount Deposited from Lco Portal. EASEBUZZ payment with Ref No- RC_CFbyZj) ","","11000.00","","24002.29"
"21","TCCL1002 - KUMAR CABLE NETWORK ( TNTDNTCCL1002 ) ","2023-08-20 17:38:27","DDL1659556140","Deduction","C0798097","","12.56","23989.73"
"22","TCCL1002 - KUMAR CABLE NETWORK ( TNTDNTCCL1002 ) ","2023-08-20 17:38:27","DDL1659556145","Deduction","C0798097","","30.03","23959.7"
"23","TCCL1002 - KUMAR CABLE NETWORK ( TNTDNTCCL1002 ) ","2023-08-20 19:21:02","DDL1659971323","Deduction","C1459332","","13.70","23946"
"24","TCCL1002 - KUMAR CABLE NETWORK ( TNTDNTCCL1002 ) ","2023-08-20 19:21:02","DDL1659971333","Deduction","C1459332","","32.76","23913.24"
"25","TCCL1002 - KUMAR CABLE NETWORK ( TNTDNTCCL1002 ) ","2023-08-20 20:01:37","DDL1660202098","Deduction","C5130819","","13.70","23899.54"
"26","TCCL1002 - KUMAR CABLE NETWORK ( TNTDNTCCL1002 ) ","2023-08-20 20:01:37","DDL1660202113","Deduction","C5130819","","32.76","23866.78"
"27","TCCL1002 - KUMAR CABLE NETWORK ( TNTDNTCCL1002 ) ","2023-08-21 07:10:25","DDL1662100541","Deduction","C0757509","","35.40","23831.38"
"28","TCCL1002 - KUMAR CABLE NETWORK ( TNTDNTCCL1002 ) ","2023-08-21 07:10:25","DDL1662100546","Deduction","C0757509","","84.61","23746.77"
"29","TCCL1002 - KUMAR CABLE NETWORK ( TNTDNTCCL1002 ) ","2023-08-21 07:10:25","DDL1662100551","Deduction","C1250634","","35.40","23711.37"
"30","TCCL1002 - KUMAR CABLE NETWORK ( TNTDNTCCL1002 ) ","2023-08-21 07:10:25","DDL1662100556","Deduction","C1250634","","84.61","23626.76"
"31","TCCL1002 - KUMAR CABLE NETWORK ( TNTDNTCCL1002 ) ","2023-08-21 07:10:25","DDL1662100561","Deduction","C1432101","","35.40","23591.36"
"32","TCCL1002 - KUMAR CABLE NETWORK ( TNTDNTCCL1002 ) ","2023-08-21 07:10:25","DDL1662100566","Deduction","C1432101","","84.61","23506.75"
"33","TCCL1002 - KUMAR CABLE NETWORK ( TNTDNTCCL1002 ) ","2023-08-21 07:10:26","DDL1662100571","Deduction","C4073642","","35.40","23471.35"
"34","TCCL1002 - KUMAR CABLE NETWORK ( TNTDNTCCL1002 ) ","2023-08-21 07:10:26","DDL1662100576","Deduction","C4073642","","84.61","23386.74"
"35","TCCL1002 - KUMAR CABLE NETWORK ( TNTDNTCCL1002 ) ","2023-08-21 07:10:26","DDL1662100581","Deduction","C3896312","","35.40","23351.34"
"36","TCCL1002 - KUMAR CABLE NETWORK ( TNTDNTCCL1002 ) ","2023-08-21 07:10:26","DDL1662100586","Deduction","C3896312","","84.61","23266.73"
"37","TCCL1002 - KUMAR CABLE NETWORK ( TNTDNTCCL1002 ) ","2023-08-21 07:10:26","DDL1662100591","Deduction","C1237806","","35.40","23231.33"
"38","TCCL1002 - KUMAR CABLE NETWORK ( TNTDNTCCL1002 ) ","2023-08-21 07:10:26","DDL1662100596","Deduction","C1237806","","84.61","23146.72"
"39","TCCL1002 - KUMAR CABLE NETWORK ( TNTDNTCCL1002 ) ","2023-08-21 07:10:26","DDL1662100601","Deduction","C1238666","","35.40","23111.32"
"40","TCCL1002 - KUMAR CABLE NETWORK ( TNTDNTCCL1002 ) ","2023-08-21 07:10:26","DDL1662100606","Deduction","C1238666","","84.61","23026.71"
"41","TCCL1002 - KUMAR CABLE NETWORK ( TNTDNTCCL1002 ) ","2023-08-21 07:10:26","DDL1662100616","Deduction","C2227396","","35.40","22991.31"
"42","TCCL1002 - KUMAR CABLE NETWORK ( TNTDNTCCL1002 ) ","2023-08-21 07:10:26","DDL1662100621","Deduction","C2227396","","84.61","22906.7"
"43","TCCL1002 - KUMAR CABLE NETWORK ( TNTDNTCCL1002 ) ","2023-08-21 07:10:26","DDL1662100631","Deduction","C1437253","","35.40","22871.3"
"44","TCCL1002 - KUMAR CABLE NETWORK ( TNTDNTCCL1002 ) ","2023-08-21 07:10:26","DDL1662100636","Deduction","C1437253","","84.61","22786.69"
"45","TCCL1002 - KUMAR CABLE NETWORK ( TNTDNTCCL1002 ) ","2023-08-21 07:10:26","DDL1662100641","Deduction","C6267661","","35.40","22751.29"
"46","TCCL1002 - KUMAR CABLE NETWORK ( TNTDNTCCL1002 ) ","2023-08-21 07:10:26","DDL1662100646","Deduction","C6267661","","84.61","22666.68"
"47","TCCL1002 - KUMAR CABLE NETWORK ( TNTDNTCCL1002 ) ","2023-08-21 07:10:26","DDL1662100651","Deduction","C1468102","","35.40","22631.28"
"48","TCCL1002 - KUMAR CABLE NETWORK ( TNTDNTCCL1002 ) ","2023-08-21 07:10:26","DDL1662100656","Deduction","C1468102","","84.61","22546.67"
"49","TCCL1002 - KUMAR CABLE NETWORK ( TNTDNTCCL1002 ) ","2023-08-21 07:10:26","DDL1662100661","Deduction","C1427120","","35.40","22511.27"
"50","TCCL1002 - KUMAR CABLE NETWORK ( TNTDNTCCL1002 ) ","2023-08-21 07:10:26","DDL1662100666","Deduction","C1427120","","84.61","22426.66"
"51","TCCL1002 - KUMAR CABLE NETWORK ( TNTDNTCCL1002 ) ","2023-08-21 07:10:26","DDL1662100671","Deduction","C1554612","","35.40","22391.26"
"52","TCCL1002 - KUMAR CABLE NETWORK ( TNTDNTCCL1002 ) ","2023-08-21 07:10:26","DDL1662100676","Deduction","C1554612","","84.61","22306.65"
"53","TCCL1002 - KUMAR CABLE NETWORK ( TNTDNTCCL1002 ) ","2023-08-21 07:10:26","DDL1662100681","Deduction","C5684330","","35.40","22271.25"
"54","TCCL1002 - KUMAR CABLE NETWORK ( TNTDNTCCL1002 ) ","2023-08-21 07:10:26","DDL1662100686","Deduction","C5684330","","84.61","22186.64"
"55","TCCL1002 - KUMAR CABLE NETWORK ( TNTDNTCCL1002 ) ","2023-08-21 07:10:26","DDL1662100691","Deduction","C1693303","","35.40","22151.24"
"56","TCCL1002 - KUMAR CABLE NETWORK ( TNTDNTCCL1002 ) ","2023-08-21 07:10:26","DDL1662100696","Deduction","C1693303","","84.61","22066.63"
"57","TCCL1002 - KUMAR CABLE NETWORK ( TNTDNTCCL1002 ) ","2023-08-21 07:10:27","DDL1662100701","Deduction","C2161413","","35.40","22031.23"
"58","TCCL1002 - KUMAR CABLE NETWORK ( TNTDNTCCL1002 ) ","2023-08-21 07:10:27","DDL1662100706","Deduction","C2161413","","84.61","21946.62"
"59","TCCL1002 - KUMAR CABLE NETWORK ( TNTDNTCCL1002 ) ","2023-08-21 07:10:27","DDL1662100716","Deduction","C6287282","","35.40","21911.22"
"60","TCCL1002 - KUMAR CABLE NETWORK ( TNTDNTCCL1002 ) ","2023-08-21 07:10:27","DDL1662100721","Deduction","C6287282","","84.61","21826.61"
"61","TCCL1002 - KUMAR CABLE NETWORK ( TNTDNTCCL1002 ) ","2023-08-21 07:10:27","DDL1662100726","Deduction","C1426984","","35.40","21791.21"
"62","TCCL1002 - KUMAR CABLE NETWORK ( TNTDNTCCL1002 ) ","2023-08-21 07:10:27","DDL1662100731","Deduction","C1426984","","84.61","21706.6"
"63","TCCL1002 - KUMAR CABLE NETWORK ( TNTDNTCCL1002 ) ","2023-08-21 07:10:27","DDL1662100736","Deduction","C1426984","","20.18","21686.42"
"64","TCCL1002 - KUMAR CABLE NETWORK ( TNTDNTCCL1002 ) ","2023-08-21 07:10:27","DDL1662100741","Deduction","C1426984","","20.18","21666.24"
"65","TCCL1002 - KUMAR CABLE NETWORK ( TNTDNTCCL1002 ) ","2023-08-21 07:10:27","DDL1662100746","Deduction","C1426984","","20.18","21646.06"
"66","TCCL1002 - KUMAR CABLE NETWORK ( TNTDNTCCL1002 ) ","2023-08-21 07:10:27","DDL1662100756","Deduction","C1496002","","35.40","21610.66"
"67","TCCL1002 - KUMAR CABLE NETWORK ( TNTDNTCCL1002 ) ","2023-08-21 07:10:27","DDL1662100761","Deduction","C1496002","","84.61","21526.05"
"68","TCCL1002 - KUMAR CABLE NETWORK ( TNTDNTCCL1002 ) ","2023-08-21 07:10:27","DDL1662100766","Deduction","C1291196","","35.40","21490.65"
"69","TCCL1002 - KUMAR CABLE NETWORK ( TNTDNTCCL1002 ) ","2023-08-21 07:10:27","DDL1662100771","Deduction","C1291196","","84.61","21406.04"
"70","TCCL1002 - KUMAR CABLE NETWORK ( TNTDNTCCL1002 ) ","2023-08-21 07:10:27","DDL1662100776","Deduction","C2558795","","35.40","21370.64"
"71","TCCL1002 - KUMAR CABLE NETWORK ( TNTDNTCCL1002 ) ","2023-08-21 07:10:27","DDL1662100781","Deduction","C2558795","","84.61","21286.03"
"72","TCCL1002 - KUMAR CABLE NETWORK ( TNTDNTCCL1002 ) ","2023-08-21 07:10:27","DDL1662100786","Deduction","C12371501","","35.40","21250.63"
"73","TCCL1002 - KUMAR CABLE NETWORK ( TNTDNTCCL1002 ) ","2023-08-21 07:10:27","DDL1662100791","Deduction","C12371501","","84.61","21166.02"
"74","TCCL1002 - KUMAR CABLE NETWORK ( TNTDNTCCL1002 ) ","2023-08-21 07:10:27","DDL1662100796","Deduction","C5575416","","35.40","21130.62"
"75","TCCL1002 - KUMAR CABLE NETWORK ( TNTDNTCCL1002 ) ","2023-08-21 07:10:27","DDL1662100801","Deduction","C5575416","","84.61","21046.01"
"76","TCCL1002 - KUMAR CABLE NETWORK ( TNTDNTCCL1002 ) ","2023-08-21 07:10:27","DDL1662100806","Deduction","C1437301","","35.40","21010.61"
"77","TCCL1002 - KUMAR CABLE NETWORK ( TNTDNTCCL1002 ) ","2023-08-21 07:10:27","DDL1662100811","Deduction","C1437301","","84.61","20926"
"78","TCCL1002 - KUMAR CABLE NETWORK ( TNTDNTCCL1002 ) ","2023-08-21 07:10:27","DDL1662100816","Deduction","C1992670","","35.40","20890.6"
"79","TCCL1002 - KUMAR CABLE NETWORK ( TNTDNTCCL1002 ) ","2023-08-21 07:10:27","DDL1662100821","Deduction","C1992670","","84.61","20805.99"
"80","TCCL1002 - KUMAR CABLE NETWORK ( TNTDNTCCL1002 ) ","2023-08-21 07:10:27","DDL1662100826","Deduction","C1693300","","35.40","20770.59"
"81","TCCL1002 - KUMAR CABLE NETWORK ( TNTDNTCCL1002 ) ","2023-08-21 07:10:27","DDL1662100831","Deduction","C1693300","","84.61","20685.98"
"82","TCCL1002 - KUMAR CABLE NETWORK ( TNTDNTCCL1002 ) ","2023-08-21 07:10:27","DDL1662100841","Deduction","C1087161","","35.40","20650.58"
"83","TCCL1002 - KUMAR CABLE NETWORK ( TNTDNTCCL1002 ) ","2023-08-21 07:10:27","DDL1662100846","Deduction","C1087161","","124.60","20525.98"
"84","TCCL1002 - KUMAR CABLE NETWORK ( TNTDNTCCL1002 ) ","2023-08-21 07:10:27","DDL1662100851","Deduction","C3379807","","35.40","20490.58"
"85","TCCL1002 - KUMAR CABLE NETWORK ( TNTDNTCCL1002 ) ","2023-08-21 07:10:28","DDL1662100856","Deduction","C3379807","","84.61","20405.97"
"86","TCCL1002 - KUMAR CABLE NETWORK ( TNTDNTCCL1002 ) ","2023-08-21 07:10:28","DDL1662100866","Deduction","C7395841","","35.40","20370.57"
"87","TCCL1002 - KUMAR CABLE NETWORK ( TNTDNTCCL1002 ) ","2023-08-21 07:10:28","DDL1662100871","Deduction","C7395841","","84.61","20285.96"
"88","TCCL1002 - KUMAR CABLE NETWORK ( TNTDNTCCL1002 ) ","2023-08-21 07:10:28","DDL1662100876","Deduction","C2051654","","35.40","20250.56"
"89","TCCL1002 - KUMAR CABLE NETWORK ( TNTDNTCCL1002 ) ","2023-08-21 07:10:28","DDL1662100881","Deduction","C2051654","","84.61","20165.95"
"90","TCCL1002 - KUMAR CABLE NETWORK ( TNTDNTCCL1002 ) ","2023-08-21 07:10:28","DDL1662100886","Deduction","C1426720","","35.40","20130.55"
"91","TCCL1002 - KUMAR CABLE NETWORK ( TNTDNTCCL1002 ) ","2023-08-21 07:10:28","DDL1662100891","Deduction","C1426720","","84.61","20045.94"
"92","TCCL1002 - KUMAR CABLE NETWORK ( TNTDNTCCL1002 ) ","2023-08-21 07:10:28","DDL1662100896","Deduction","C1425593","","35.40","20010.54"
"93","TCCL1002 - KUMAR CABLE NETWORK ( TNTDNTCCL1002 ) ","2023-08-21 07:10:28","DDL1662100901","Deduction","C1425593","","84.61","19925.93"
"94","TCCL1002 - KUMAR CABLE NETWORK ( TNTDNTCCL1002 ) ","2023-08-21 07:10:28","DDL1662100906","Deduction","C2334200","","35.40","19890.53"
"95","TCCL1002 - KUMAR CABLE NETWORK ( TNTDNTCCL1002 ) ","2023-08-21 07:10:28","DDL1662100911","Deduction","C2334200","","84.61","19805.92"
"96","TCCL1002 - KUMAR CABLE NETWORK ( TNTDNTCCL1002 ) ","2023-08-21 07:10:28","DDL1662100916","Deduction","C1468093","","35.40","19770.52"
"97","TCCL1002 - KUMAR CABLE NETWORK ( TNTDNTCCL1002 ) ","2023-08-21 07:10:28","DDL1662100921","Deduction","C1468093","","84.61","19685.91"
"98","TCCL1002 - KUMAR CABLE NETWORK ( TNTDNTCCL1002 ) ","2023-08-21 07:10:28","DDL1662100926","Deduction","C1693302","","35.40","19650.51"
"99","TCCL1002 - KUMAR CABLE NETWORK ( TNTDNTCCL1002 ) ","2023-08-21 07:10:28","DDL1662100931","Deduction","C1693302","","84.61","19565.9"
"100","TCCL1002 - KUMAR CABLE NETWORK ( TNTDNTCCL1002 ) ","2023-08-21 07:10:28","DDL1662100936","Deduction","C1554615","","35.40","19530.5"
"101","TCCL1002 - KUMAR CABLE NETWORK ( TNTDNTCCL1002 ) ","2023-08-21 07:10:28","DDL1662100941","Deduction","C1554615","","84.61","19445.89"
"102","TCCL1002 - KUMAR CABLE NETWORK ( TNTDNTCCL1002 ) ","2023-08-21 07:10:28","DDL1662100951","Deduction","C5130647","","35.40","19410.49"
"103","TCCL1002 - KUMAR CABLE NETWORK ( TNTDNTCCL1002 ) ","2023-08-21 07:10:28","DDL1662100956","Deduction","C5130647","","84.61","19325.88"
"104","TCCL1002 - KUMAR CABLE NETWORK ( TNTDNTCCL1002 ) ","2023-08-21 07:10:28","DDL1662100961","Deduction","C5130647","","20.18","19305.7"
"105","TCCL1002 - KUMAR CABLE NETWORK ( TNTDNTCCL1002 ) ","2023-08-21 07:10:28","DDL1662100966","Deduction","C5130647","","20.18","19285.52"
"106","TCCL1002 - KUMAR CABLE NETWORK ( TNTDNTCCL1002 ) ","2023-08-21 07:10:28","DDL1662100971","Deduction","C5130647","","20.18","19265.34"
"107","TCCL1002 - KUMAR CABLE NETWORK ( TNTDNTCCL1002 ) ","2023-08-21 07:10:28","DDL1662100981","Deduction","C1495996","","35.40","19229.94"
"108","TCCL1002 - KUMAR CABLE NETWORK ( TNTDNTCCL1002 ) ","2023-08-21 07:10:28","DDL1662100986","Deduction","C1495996","","84.61","19145.33"
"109","TCCL1002 - KUMAR CABLE NETWORK ( TNTDNTCCL1002 ) ","2023-08-21 07:10:28","DDL1662100991","Deduction","C8916676","","35.40","19109.93"
"110","TCCL1002 - KUMAR CABLE NETWORK ( TNTDNTCCL1002 ) ","2023-08-21 07:10:28","DDL1662100996","Deduction","C8916676","","84.61","19025.32"
"111","TCCL1002 - KUMAR CABLE NETWORK ( TNTDNTCCL1002 ) ","2023-08-21 07:10:28","DDL1662101001","Deduction","C1448881","","35.40","18989.92"
"112","TCCL1002 - KUMAR CABLE NETWORK ( TNTDNTCCL1002 ) ","2023-08-21 07:10:28","DDL1662101006","Deduction","C1448881","","84.61","18905.31"
"113","TCCL1002 - KUMAR CABLE NETWORK ( TNTDNTCCL1002 ) ","2023-08-21 07:10:29","DDL1662101011","Deduction","C4993282","","35.40","18869.91"
"114","TCCL1002 - KUMAR CABLE NETWORK ( TNTDNTCCL1002 ) ","2023-08-21 07:10:29","DDL1662101016","Deduction","C4993282","","84.61","18785.3"
"115","TCCL1002 - KUMAR CABLE NETWORK ( TNTDNTCCL1002 ) ","2023-08-21 07:10:29","DDL1662101021","Deduction","C1468095","","35.40","18749.9"
"116","TCCL1002 - KUMAR CABLE NETWORK ( TNTDNTCCL1002 ) ","2023-08-21 07:10:29","DDL1662101026","Deduction","C1468095","","84.61","18665.29"
"117","TCCL1002 - KUMAR CABLE NETWORK ( TNTDNTCCL1002 ) ","2023-08-21 07:10:29","DDL1662101031","Deduction","C4183113","","35.40","18629.89"
"118","TCCL1002 - KUMAR CABLE NETWORK ( TNTDNTCCL1002 ) ","2023-08-21 07:10:29","DDL1662101036","Deduction","C4183113","","84.61","18545.28"
"119","TCCL1002 - KUMAR CABLE NETWORK ( TNTDNTCCL1002 ) ","2023-08-21 07:10:29","DDL1662101041","Deduction","C1291191","","35.40","18509.88"
"120","TCCL1002 - KUMAR CABLE NETWORK ( TNTDNTCCL1002 ) ","2023-08-21 07:10:29","DDL1662101046","Deduction","C1291191","","84.61","18425.27"
"121","TCCL1002 - KUMAR CABLE NETWORK ( TNTDNTCCL1002 ) ","2023-08-21 07:10:29","DDL1662101051","Deduction","C1427146","","35.40","18389.87"
"122","TCCL1002 - KUMAR CABLE NETWORK ( TNTDNTCCL1002 ) ","2023-08-21 07:10:29","DDL1662101056","Deduction","C1427146","","84.61","18305.26"
"123","TCCL1002 - KUMAR CABLE NETWORK ( TNTDNTCCL1002 ) ","2023-08-21 07:10:29","DDL1662101061","Deduction","C5056626","","35.40","18269.86"
"124","TCCL1002 - KUMAR CABLE NETWORK ( TNTDNTCCL1002 ) ","2023-08-21 07:10:29","DDL1662101066","Deduction","C5056626","","84.61","18185.25"
"125","TCCL1002 - KUMAR CABLE NETWORK ( TNTDNTCCL1002 ) ","2023-08-21 07:10:29","DDL1662101076","Deduction","C1468097","","22.84","18162.41"
"126","TCCL1002 - KUMAR CABLE NETWORK ( TNTDNTCCL1002 ) ","2023-08-21 07:10:29","DDL1662101081","Deduction","C1468097","","54.59","18107.82"
"127","TCCL1002 - KUMAR CABLE NETWORK ( TNTDNTCCL1002 ) ","2023-08-21 07:10:29","DDL1662101086","Deduction","C3737584","","35.40","18072.42"
"128","TCCL1002 - KUMAR CABLE NETWORK ( TNTDNTCCL1002 ) ","2023-08-21 07:10:29","DDL1662101091","Deduction","C3737584","","84.61","17987.81"
"129","TCCL1002 - KUMAR CABLE NETWORK ( TNTDNTCCL1002 ) ","2023-08-21 07:10:29","DDL1662101101","Deduction","C1468101","","35.40","17952.41"
"130","TCCL1002 - KUMAR CABLE NETWORK ( TNTDNTCCL1002 ) ","2023-08-21 07:10:29","DDL1662101106","Deduction","C1468101","","84.61","17867.8"
"131","TCCL1002 - KUMAR CABLE NETWORK ( TNTDNTCCL1002 ) ","2023-08-21 07:10:29","DDL1662101111","Deduction","C2149806","","35.40","17832.4"
"132","TCCL1002 - KUMAR CABLE NETWORK ( TNTDNTCCL1002 ) ","2023-08-21 07:10:29","DDL1662101116","Deduction","C2149806","","84.61","17747.79"
"133","TCCL1002 - KUMAR CABLE NETWORK ( TNTDNTCCL1002 ) ","2023-08-21 07:10:29","DDL1662101121","Deduction","C1427055","","35.40","17712.39"
"134","TCCL1002 - KUMAR CABLE NETWORK ( TNTDNTCCL1002 ) ","2023-08-21 07:10:29","DDL1662101126","Deduction","C1427055","","84.61","17627.78"
"135","TCCL1002 - KUMAR CABLE NETWORK ( TNTDNTCCL1002 ) ","2023-08-21 07:10:29","DDL1662101131","Deduction","C6351898","","35.40","17592.38"
"136","TCCL1002 - KUMAR CABLE NETWORK ( TNTDNTCCL1002 ) ","2023-08-21 07:10:29","DDL1662101136","Deduction","C6351898","","84.61","17507.77"
"137","TCCL1002 - KUMAR CABLE NETWORK ( TNTDNTCCL1002 ) ","2023-08-21 07:10:29","DDL1662101141","Deduction","C12213465","","35.40","17472.37"
"138","TCCL1002 - KUMAR CABLE NETWORK ( TNTDNTCCL1002 ) ","2023-08-21 07:10:29","DDL1662101146","Deduction","C12213465","","84.61","17387.76"
"139","TCCL1002 - KUMAR CABLE NETWORK ( TNTDNTCCL1002 ) ","2023-08-21 07:10:29","DDL1662101151","Deduction","C1427641","","35.40","17352.36"
"140","TCCL1002 - KUMAR CABLE NETWORK ( TNTDNTCCL1002 ) ","2023-08-21 07:10:29","DDL1662101156","Deduction","C1427641","","84.61","17267.75"
"141","TCCL1002 - KUMAR CABLE NETWORK ( TNTDNTCCL1002 ) ","2023-08-21 07:10:30","DDL1662101161","Deduction","C1291193","","35.40","17232.35"
"142","TCCL1002 - KUMAR CABLE NETWORK ( TNTDNTCCL1002 ) ","2023-08-21 07:10:30","DDL1662101166","Deduction","C1291193","","84.61","17147.74"
"143","TCCL1002 - KUMAR CABLE NETWORK ( TNTDNTCCL1002 ) ","2023-08-21 07:10:30","DDL1662101171","Deduction","C1244143","","35.40","17112.34"
"144","TCCL1002 - KUMAR CABLE NETWORK ( TNTDNTCCL1002 ) ","2023-08-21 07:10:30","DDL1662101176","Deduction","C1244143","","84.61","17027.73"
"145","TCCL1002 - KUMAR CABLE NETWORK ( TNTDNTCCL1002 ) ","2023-08-21 07:10:30","DDL1662101181","Deduction","C1432090","","35.40","16992.33"
"146","TCCL1002 - KUMAR CABLE NETWORK ( TNTDNTCCL1002 ) ","2023-08-21 07:10:30","DDL1662101186","Deduction","C1432090","","84.61","16907.72"
"147","TCCL1002 - KUMAR CABLE NETWORK ( TNTDNTCCL1002 ) ","2023-08-21 07:10:30","DDL1662101191","Deduction","C4300560","","35.40","16872.32"
"148","TCCL1002 - KUMAR CABLE NETWORK ( TNTDNTCCL1002 ) ","2023-08-21 07:10:30","DDL1662101196","Deduction","C4300560","","84.61","16787.71"
"149","TCCL1002 - KUMAR CABLE NETWORK ( TNTDNTCCL1002 ) ","2023-08-21 07:10:30","DDL1662101201","Deduction","C1291189","","35.40","16752.31"
"150","TCCL1002 - KUMAR CABLE NETWORK ( TNTDNTCCL1002 ) ","2023-08-21 07:10:30","DDL1662101206","Deduction","C1291189","","84.61","16667.7"
"151","TCCL1002 - KUMAR CABLE NETWORK ( TNTDNTCCL1002 ) ","2023-08-21 07:10:30","DDL1662101211","Deduction","C3875743","","35.40","16632.3"
"152","TCCL1002 - KUMAR CABLE NETWORK ( TNTDNTCCL1002 ) ","2023-08-21 07:10:30","DDL1662101216","Deduction","C3875743","","84.61","16547.69"
"153","TCCL1002 - KUMAR CABLE NETWORK ( TNTDNTCCL1002 ) ","2023-08-21 07:10:30","DDL1662101221","Deduction","C4300548","","22.84","16524.85"
"154","TCCL1002 - KUMAR CABLE NETWORK ( TNTDNTCCL1002 ) ","2023-08-21 07:10:30","DDL1662101226","Deduction","C4300548","","54.59","16470.26"
"155","TCCL1002 - KUMAR CABLE NETWORK ( TNTDNTCCL1002 ) ","2023-08-21 07:10:30","DDL1662101231","Deduction","C0769247","","17.13","16453.13"
"156","TCCL1002 - KUMAR CABLE NETWORK ( TNTDNTCCL1002 ) ","2023-08-21 07:10:30","DDL1662101236","Deduction","C0769247","","40.94","16412.19"
"157","TCCL1002 - KUMAR CABLE NETWORK ( TNTDNTCCL1002 ) ","2023-08-21 07:10:30","DDL1662101241","Deduction","C0756488","","35.40","16376.79"
"158","TCCL1002 - KUMAR CABLE NETWORK ( TNTDNTCCL1002 ) ","2023-08-21 07:10:30","DDL1662101246","Deduction","C0756488","","84.61","16292.18"
"159","TCCL1002 - KUMAR CABLE NETWORK ( TNTDNTCCL1002 ) ","2023-08-21 07:10:30","DDL1662101251","Deduction","C3342594","","35.40","16256.78"
"160","TCCL1002 - KUMAR CABLE NETWORK ( TNTDNTCCL1002 ) ","2023-08-21 07:10:30","DDL1662101256","Deduction","C3342594","","84.61","16172.17"
"161","TCCL1002 - KUMAR CABLE NETWORK ( TNTDNTCCL1002 ) ","2023-08-21 07:10:30","DDL1662101261","Deduction","C1437360","","35.40","16136.77"
"162","TCCL1002 - KUMAR CABLE NETWORK ( TNTDNTCCL1002 ) ","2023-08-21 07:10:30","DDL1662101266","Deduction","C1437360","","84.61","16052.16"
"163","TCCL1002 - KUMAR CABLE NETWORK ( TNTDNTCCL1002 ) ","2023-08-21 07:10:30","DDL1662101271","Deduction","C2334438","","35.40","16016.76"
"164","TCCL1002 - KUMAR CABLE NETWORK ( TNTDNTCCL1002 ) ","2023-08-21 07:10:30","DDL1662101276","Deduction","C2334438","","84.61","15932.15"
"165","TCCL1002 - KUMAR CABLE NETWORK ( TNTDNTCCL1002 ) ","2023-08-21 07:10:30","DDL1662101281","Deduction","C0769358","","35.40","15896.75"
"166","TCCL1002 - KUMAR CABLE NETWORK ( TNTDNTCCL1002 ) ","2023-08-21 07:10:30","DDL1662101286","Deduction","C0769358","","84.61","15812.14"
"167","TCCL1002 - KUMAR CABLE NETWORK ( TNTDNTCCL1002 ) ","2023-08-21 07:10:30","DDL1662101291","Deduction","C7832592","","35.40","15776.74"
"168","TCCL1002 - KUMAR CABLE NETWORK ( TNTDNTCCL1002 ) ","2023-08-21 07:10:30","DDL1662101296","Deduction","C7832592","","84.61","15692.13"
"169","TCCL1002 - KUMAR CABLE NETWORK ( TNTDNTCCL1002 ) ","2023-08-21 07:10:31","DDL1662101301","Deduction","C4184972","","35.40","15656.73"
"170","TCCL1002 - KUMAR CABLE NETWORK ( TNTDNTCCL1002 ) ","2023-08-21 07:10:31","DDL1662101306","Deduction","C4184972","","84.61","15572.12"
"171","TCCL1002 - KUMAR CABLE NETWORK ( TNTDNTCCL1002 ) ","2023-08-21 07:10:31","DDL1662101311","Deduction","C6144382","","35.40","15536.72"
"172","TCCL1002 - KUMAR CABLE NETWORK ( TNTDNTCCL1002 ) ","2023-08-21 07:10:31","DDL1662101316","Deduction","C6144382","","84.61","15452.11"
"173","TCCL1002 - KUMAR CABLE NETWORK ( TNTDNTCCL1002 ) ","2023-08-21 07:10:31","DDL1662101326","Deduction","C1693301","","35.40","15416.71"
"174","TCCL1002 - KUMAR CABLE NETWORK ( TNTDNTCCL1002 ) ","2023-08-21 07:10:31","DDL1662101331","Deduction","C1693301","","124.60","15292.11"
"175","TCCL1002 - KUMAR CABLE NETWORK ( TNTDNTCCL1002 ) ","2023-08-21 07:10:31","DDL1662101336","Deduction","C2120530","","35.40","15256.71"
"176","TCCL1002 - KUMAR CABLE NETWORK ( TNTDNTCCL1002 ) ","2023-08-21 07:10:31","DDL1662101341","Deduction","C2120530","","84.61","15172.1"
"177","TCCL1002 - KUMAR CABLE NETWORK ( TNTDNTCCL1002 ) ","2023-08-21 07:10:31","DDL1662101351","Deduction","C1427006","","35.40","15136.7"
"178","TCCL1002 - KUMAR CABLE NETWORK ( TNTDNTCCL1002 ) ","2023-08-21 07:10:31","DDL1662101356","Deduction","C1427006","","84.61","15052.09"
"179","TCCL1002 - KUMAR CABLE NETWORK ( TNTDNTCCL1002 ) ","2023-08-21 07:10:31","DDL1662101361","Deduction","C5076832","","35.40","15016.69"
"180","TCCL1002 - KUMAR CABLE NETWORK ( TNTDNTCCL1002 ) ","2023-08-21 07:10:31","DDL1662101366","Deduction","C5076832","","84.61","14932.08"
"181","TCCL1002 - KUMAR CABLE NETWORK ( TNTDNTCCL1002 ) ","2023-08-21 07:10:31","DDL1662101371","Deduction","C1554617","","35.40","14896.68"
"182","TCCL1002 - KUMAR CABLE NETWORK ( TNTDNTCCL1002 ) ","2023-08-21 07:10:31","DDL1662101376","Deduction","C1554617","","84.61","14812.07"
"183","TCCL1002 - KUMAR CABLE NETWORK ( TNTDNTCCL1002 ) ","2023-08-21 07:10:31","DDL1662101381","Deduction","C11943237","","22.84","14789.23"
"184","TCCL1002 - KUMAR CABLE NETWORK ( TNTDNTCCL1002 ) ","2023-08-21 07:10:31","DDL1662101386","Deduction","C11943237","","54.59","14734.64"
"185","TCCL1002 - KUMAR CABLE NETWORK ( TNTDNTCCL1002 ) ","2023-08-21 07:10:31","DDL1662101391","Deduction","C1554069","","35.40","14699.24"
"186","TCCL1002 - KUMAR CABLE NETWORK ( TNTDNTCCL1002 ) ","2023-08-21 07:10:31","DDL1662101396","Deduction","C1554069","","84.61","14614.63"
"187","TCCL1002 - KUMAR CABLE NETWORK ( TNTDNTCCL1002 ) ","2023-08-21 07:10:31","DDL1662101401","Deduction","C1010021","","35.40","14579.23"
"188","TCCL1002 - KUMAR CABLE NETWORK ( TNTDNTCCL1002 ) ","2023-08-21 07:10:31","DDL1662101406","Deduction","C1010021","","84.61","14494.62"
"189","TCCL1002 - KUMAR CABLE NETWORK ( TNTDNTCCL1002 ) ","2023-08-21 07:10:31","DDL1662101411","Deduction","C11942814","","35.40","14459.22"
"190","TCCL1002 - KUMAR CABLE NETWORK ( TNTDNTCCL1002 ) ","2023-08-21 07:10:31","DDL1662101416","Deduction","C11942814","","84.61","14374.61"
"191","TCCL1002 - KUMAR CABLE NETWORK ( TNTDNTCCL1002 ) ","2023-08-21 07:10:31","DDL1662101421","Deduction","C5146791","","35.40","14339.21"
"192","TCCL1002 - KUMAR CABLE NETWORK ( TNTDNTCCL1002 ) ","2023-08-21 07:10:31","DDL1662101426","Deduction","C5146791","","84.61","14254.6"
"193","TCCL1002 - KUMAR CABLE NETWORK ( TNTDNTCCL1002 ) ","2023-08-21 07:10:31","DDL1662101431","Deduction","C8719391","","35.40","14219.2"
"194","TCCL1002 - KUMAR CABLE NETWORK ( TNTDNTCCL1002 ) ","2023-08-21 07:10:31","DDL1662101436","Deduction","C8719391","","84.61","14134.59"
"195","TCCL1002 - KUMAR CABLE NETWORK ( TNTDNTCCL1002 ) ","2023-08-21 07:10:31","DDL1662101441","Deduction","C1676819","","35.40","14099.19"
"196","TCCL1002 - KUMAR CABLE NETWORK ( TNTDNTCCL1002 ) ","2023-08-21 07:10:31","DDL1662101446","Deduction","C1676819","","84.61","14014.58"
"197","TCCL1002 - KUMAR CABLE NETWORK ( TNTDNTCCL1002 ) ","2023-08-21 07:10:31","DDL1662101451","Deduction","C1459282","","35.40","13979.18"
"198","TCCL1002 - KUMAR CABLE NETWORK ( TNTDNTCCL1002 ) ","2023-08-21 07:10:31","DDL1662101456","Deduction","C1459282","","84.61","13894.57"
"199","TCCL1002 - KUMAR CABLE NETWORK ( TNTDNTCCL1002 ) ","2023-08-21 07:10:32","DDL1662101461","Deduction","C1291192","","35.40","13859.17"
"200","TCCL1002 - KUMAR CABLE NETWORK ( TNTDNTCCL1002 ) ","2023-08-21 07:10:32","DDL1662101466","Deduction","C1291192","","84.61","13774.56"
"201","TCCL1002 - KUMAR CABLE NETWORK ( TNTDNTCCL1002 ) ","2023-08-21 07:10:32","DDL1662101476","Deduction","C4300557","","35.40","13739.16"
"202","TCCL1002 - KUMAR CABLE NETWORK ( TNTDNTCCL1002 ) ","2023-08-21 07:10:32","DDL1662101481","Deduction","C4300557","","84.61","13654.55"
"203","TCCL1002 - KUMAR CABLE NETWORK ( TNTDNTCCL1002 ) ","2023-08-21 07:10:32","DDL1662101486","Deduction","C6725457","","35.40","13619.15"
"204","TCCL1002 - KUMAR CABLE NETWORK ( TNTDNTCCL1002 ) ","2023-08-21 07:10:32","DDL1662101491","Deduction","C6725457","","84.61","13534.54"
"205","TCCL1002 - KUMAR CABLE NETWORK ( TNTDNTCCL1002 ) ","2023-08-21 07:10:32","DDL1662101501","Deduction","C1468096","","35.40","13499.14"
"206","TCCL1002 - KUMAR CABLE NETWORK ( TNTDNTCCL1002 ) ","2023-08-21 07:10:32","DDL1662101506","Deduction","C1468096","","84.61","13414.53"
"207","TCCL1002 - KUMAR CABLE NETWORK ( TNTDNTCCL1002 ) ","2023-08-21 07:10:32","DDL1662101511","Deduction","C3341959","","35.40","13379.13"
"208","TCCL1002 - KUMAR CABLE NETWORK ( TNTDNTCCL1002 ) ","2023-08-21 07:10:32","DDL1662101516","Deduction","C3341959","","84.61","13294.52"
"209","TCCL1002 - KUMAR CABLE NETWORK ( TNTDNTCCL1002 ) ","2023-08-21 07:10:32","DDL1662101521","Deduction","C4083997","","17.13","13277.39"
"210","TCCL1002 - KUMAR CABLE NETWORK ( TNTDNTCCL1002 ) ","2023-08-21 07:10:32","DDL1662101526","Deduction","C4083997","","40.94","13236.45"
"211","TCCL1002 - KUMAR CABLE NETWORK ( TNTDNTCCL1002 ) ","2023-08-21 07:10:32","DDL1662101531","Deduction","C3066959","","35.40","13201.05"
"212","TCCL1002 - KUMAR CABLE NETWORK ( TNTDNTCCL1002 ) ","2023-08-21 07:10:32","DDL1662101536","Deduction","C3066959","","124.60","13076.45"
"213","TCCL1002 - KUMAR CABLE NETWORK ( TNTDNTCCL1002 ) ","2023-08-21 07:10:32","DDL1662101541","Deduction","C2112697","","35.40","13041.05"
"214","TCCL1002 - KUMAR CABLE NETWORK ( TNTDNTCCL1002 ) ","2023-08-21 07:10:32","DDL1662101546","Deduction","C2112697","","84.61","12956.44"
"215","TCCL1002 - KUMAR CABLE NETWORK ( TNTDNTCCL1002 ) ","2023-08-21 07:10:32","DDL1662101551","Deduction","C8151612","","35.40","12921.04"
"216","TCCL1002 - KUMAR CABLE NETWORK ( TNTDNTCCL1002 ) ","2023-08-21 07:10:32","DDL1662101556","Deduction","C8151612","","84.61","12836.43"
"217","TCCL1002 - KUMAR CABLE NETWORK ( TNTDNTCCL1002 ) ","2023-08-21 07:10:32","DDL1662101561","Deduction","C1554616","","35.40","12801.03"
"218","TCCL1002 - KUMAR CABLE NETWORK ( TNTDNTCCL1002 ) ","2023-08-21 07:10:32","DDL1662101566","Deduction","C1554616","","84.61","12716.42"
"219","TCCL1002 - KUMAR CABLE NETWORK ( TNTDNTCCL1002 ) ","2023-08-21 07:10:32","DDL1662101576","Deduction","C1449005","","35.40","12681.02"
"220","TCCL1002 - KUMAR CABLE NETWORK ( TNTDNTCCL1002 ) ","2023-08-21 07:10:32","DDL1662101581","Deduction","C1449005","","84.61","12596.41"
"221","TCCL1002 - KUMAR CABLE NETWORK ( TNTDNTCCL1002 ) ","2023-08-21 07:10:32","DDL1662101586","Deduction","C7419138","","35.40","12561.01"
"222","TCCL1002 - KUMAR CABLE NETWORK ( TNTDNTCCL1002 ) ","2023-08-21 07:10:32","DDL1662101591","Deduction","C7419138","","84.61","12476.4"
"223","TCCL1002 - KUMAR CABLE NETWORK ( TNTDNTCCL1002 ) ","2023-08-21 07:10:32","DDL1662101596","Deduction","C1459338","","17.13","12459.27"
"224","TCCL1002 - KUMAR CABLE NETWORK ( TNTDNTCCL1002 ) ","2023-08-21 07:10:32","DDL1662101601","Deduction","C1459338","","40.94","12418.33"
"225","TCCL1002 - KUMAR CABLE NETWORK ( TNTDNTCCL1002 ) ","2023-08-21 07:10:32","DDL1662101611","Deduction","C1432100","","12.56","12405.77"
"226","TCCL1002 - KUMAR CABLE NETWORK ( TNTDNTCCL1002 ) ","2023-08-21 07:10:32","DDL1662101616","Deduction","C1432100","","30.02","12375.75"
"227","TCCL1002 - KUMAR CABLE NETWORK ( TNTDNTCCL1002 ) ","2023-08-21 07:10:33","DDL1662101621","Deduction","C1554613","","35.40","12340.35"
"228","TCCL1002 - KUMAR CABLE NETWORK ( TNTDNTCCL1002 ) ","2023-08-21 07:10:33","DDL1662101626","Deduction","C1554613","","84.61","12255.74"
"229","TCCL1002 - KUMAR CABLE NETWORK ( TNTDNTCCL1002 ) ","2023-08-21 07:10:33","DDL1662101636","Deduction","C7346395","","35.40","12220.34"
"230","TCCL1002 - KUMAR CABLE NETWORK ( TNTDNTCCL1002 ) ","2023-08-21 07:10:33","DDL1662101641","Deduction","C7346395","","84.61","12135.73"
"231","TCCL1002 - KUMAR CABLE NETWORK ( TNTDNTCCL1002 ) ","2023-08-21 07:10:33","DDL1662101646","Deduction","C9246684","","35.40","12100.33"
"232","TCCL1002 - KUMAR CABLE NETWORK ( TNTDNTCCL1002 ) ","2023-08-21 07:10:33","DDL1662101651","Deduction","C9246684","","84.61","12015.72"
"233","TCCL1002 - KUMAR CABLE NETWORK ( TNTDNTCCL1002 ) ","2023-08-21 07:10:33","DDL1662101656","Deduction","C2051430","","35.40","11980.32"
"234","TCCL1002 - KUMAR CABLE NETWORK ( TNTDNTCCL1002 ) ","2023-08-21 07:10:33","DDL1662101661","Deduction","C2051430","","84.61","11895.71"
"235","TCCL1002 - KUMAR CABLE NETWORK ( TNTDNTCCL1002 ) ","2023-08-21 07:10:33","DDL1662101666","Deduction","C1495997","","35.40","11860.31"
"236","TCCL1002 - KUMAR CABLE NETWORK ( TNTDNTCCL1002 ) ","2023-08-21 07:10:33","DDL1662101671","Deduction","C1495997","","84.61","11775.7"
"237","TCCL1002 - KUMAR CABLE NETWORK ( TNTDNTCCL1002 ) ","2023-08-21 07:10:33","DDL1662101676","Deduction","C0912432","","35.40","11740.3"
"238","TCCL1002 - KUMAR CABLE NETWORK ( TNTDNTCCL1002 ) ","2023-08-21 07:10:33","DDL1662101681","Deduction","C0912432","","84.61","11655.69"
"239","TCCL1002 - KUMAR CABLE NETWORK ( TNTDNTCCL1002 ) ","2023-08-21 07:10:33","DDL1662101686","Deduction","C11943750","","35.40","11620.29"
"240","TCCL1002 - KUMAR CABLE NETWORK ( TNTDNTCCL1002 ) ","2023-08-21 07:10:33","DDL1662101691","Deduction","C11943750","","84.61","11535.68"
"241","TCCL1002 - KUMAR CABLE NETWORK ( TNTDNTCCL1002 ) ","2023-08-21 07:10:33","DDL1662101696","Deduction","C12335179","","35.40","11500.28"
"242","TCCL1002 - KUMAR CABLE NETWORK ( TNTDNTCCL1002 ) ","2023-08-21 07:10:33","DDL1662101701","Deduction","C12335179","","84.61","11415.67"
"243","TCCL1002 - KUMAR CABLE NETWORK ( TNTDNTCCL1002 ) ","2023-08-21 07:10:33","DDL1662101706","Deduction","C3913039","","35.40","11380.27"
"244","TCCL1002 - KUMAR CABLE NETWORK ( TNTDNTCCL1002 ) ","2023-08-21 07:10:33","DDL1662101711","Deduction","C3913039","","84.61","11295.66"
"245","TCCL1002 - KUMAR CABLE NETWORK ( TNTDNTCCL1002 ) ","2023-08-21 07:10:33","DDL1662101716","Deduction","C1448515","","35.40","11260.26"
"246","TCCL1002 - KUMAR CABLE NETWORK ( TNTDNTCCL1002 ) ","2023-08-21 07:10:33","DDL1662101721","Deduction","C1448515","","63.72","11196.54"
"247","TCCL1002 - KUMAR CABLE NETWORK ( TNTDNTCCL1002 ) ","2023-08-21 07:10:33","DDL1662101726","Deduction","C1427096","","35.40","11161.14"
"248","TCCL1002 - KUMAR CABLE NETWORK ( TNTDNTCCL1002 ) ","2023-08-21 07:10:33","DDL1662101731","Deduction","C1427096","","84.61","11076.53"
"249","TCCL1002 - KUMAR CABLE NETWORK ( TNTDNTCCL1002 ) ","2023-08-21 07:10:33","DDL1662101741","Deduction","C1291197","","35.40","11041.13"
"250","TCCL1002 - KUMAR CABLE NETWORK ( TNTDNTCCL1002 ) ","2023-08-21 07:10:33","DDL1662101746","Deduction","C1291197","","84.61","10956.52"
"251","TCCL1002 - KUMAR CABLE NETWORK ( TNTDNTCCL1002 ) ","2023-08-21 07:10:33","DDL1662101751","Deduction","C1101626","","35.40","10921.12"
"252","TCCL1002 - KUMAR CABLE NETWORK ( TNTDNTCCL1002 ) ","2023-08-21 07:10:33","DDL1662101756","Deduction","C1101626","","84.61","10836.51"
"253","TCCL1002 - KUMAR CABLE NETWORK ( TNTDNTCCL1002 ) ","2023-08-21 07:10:33","DDL1662101761","Deduction","C1426504","","35.40","10801.11"
"254","TCCL1002 - KUMAR CABLE NETWORK ( TNTDNTCCL1002 ) ","2023-08-21 07:10:33","DDL1662101766","Deduction","C1426504","","84.61","10716.5"
"255","TCCL1002 - KUMAR CABLE NETWORK ( TNTDNTCCL1002 ) ","2023-08-21 07:10:33","DDL1662101771","Deduction","C0798159","","35.40","10681.1"
"256","TCCL1002 - KUMAR CABLE NETWORK ( TNTDNTCCL1002 ) ","2023-08-21 07:10:33","DDL1662101776","Deduction","C0798159","","84.61","10596.49"
"257","TCCL1002 - KUMAR CABLE NETWORK ( TNTDNTCCL1002 ) ","2023-08-21 07:10:34","DDL1662101781","Deduction","C5143534","","35.40","10561.09"
"258","TCCL1002 - KUMAR CABLE NETWORK ( TNTDNTCCL1002 ) ","2023-08-21 07:10:34","DDL1662101786","Deduction","C5143534","","84.61","10476.48"
"259","TCCL1002 - KUMAR CABLE NETWORK ( TNTDNTCCL1002 ) ","2023-08-21 07:10:34","DDL1662101791","Deduction","C1554067","","35.40","10441.08"
"260","TCCL1002 - KUMAR CABLE NETWORK ( TNTDNTCCL1002 ) ","2023-08-21 07:10:34","DDL1662101796","Deduction","C1554067","","84.61","10356.47"
"261","TCCL1002 - KUMAR CABLE NETWORK ( TNTDNTCCL1002 ) ","2023-08-21 07:10:34","DDL1662101801","Deduction","C0912367","","35.40","10321.07"
"262","TCCL1002 - KUMAR CABLE NETWORK ( TNTDNTCCL1002 ) ","2023-08-21 07:10:34","DDL1662101806","Deduction","C0912367","","84.61","10236.46"
"263","TCCL1002 - KUMAR CABLE NETWORK ( TNTDNTCCL1002 ) ","2023-08-21 07:10:34","DDL1662101811","Deduction","C4810648","","35.40","10201.06"
"264","TCCL1002 - KUMAR CABLE NETWORK ( TNTDNTCCL1002 ) ","2023-08-21 07:10:34","DDL1662101816","Deduction","C4810648","","84.61","10116.45"
"265","TCCL1002 - KUMAR CABLE NETWORK ( TNTDNTCCL1002 ) ","2023-08-21 07:10:34","DDL1662101821","Deduction","C10956878","","35.40","10081.05"
"266","TCCL1002 - KUMAR CABLE NETWORK ( TNTDNTCCL1002 ) ","2023-08-21 07:10:34","DDL1662101826","Deduction","C10956878","","84.61","9996.44"
"267","TCCL1002 - KUMAR CABLE NETWORK ( TNTDNTCCL1002 ) ","2023-08-21 07:10:34","DDL1662101831","Deduction","C1554611","","35.40","9961.04"
"268","TCCL1002 - KUMAR CABLE NETWORK ( TNTDNTCCL1002 ) ","2023-08-21 07:10:34","DDL1662101836","Deduction","C1554611","","84.61","9876.43"
"269","TCCL1002 - KUMAR CABLE NETWORK ( TNTDNTCCL1002 ) ","2023-08-21 07:10:34","DDL1662101841","Deduction","C1432096","","22.84","9853.59"
"270","TCCL1002 - KUMAR CABLE NETWORK ( TNTDNTCCL1002 ) ","2023-08-21 07:10:34","DDL1662101846","Deduction","C1432096","","54.59","9799"
"271","TCCL1002 - KUMAR CABLE NETWORK ( TNTDNTCCL1002 ) ","2023-08-21 07:10:34","DDL1662101851","Deduction","C1437289","","35.40","9763.6"
"272","TCCL1002 - KUMAR CABLE NETWORK ( TNTDNTCCL1002 ) ","2023-08-21 07:10:34","DDL1662101856","Deduction","C1437289","","84.61","9678.99"
"273","TCCL1002 - KUMAR CABLE NETWORK ( TNTDNTCCL1002 ) ","2023-08-21 07:10:34","DDL1662101861","Deduction","C0777090","","35.40","9643.59"
"274","TCCL1002 - KUMAR CABLE NETWORK ( TNTDNTCCL1002 ) ","2023-08-21 07:10:34","DDL1662101866","Deduction","C0777090","","84.61","9558.98"
"275","TCCL1002 - KUMAR CABLE NETWORK ( TNTDNTCCL1002 ) ","2023-08-21 07:10:34","DDL1662101871","Deduction","C1437320","","35.40","9523.58"
"276","TCCL1002 - KUMAR CABLE NETWORK ( TNTDNTCCL1002 ) ","2023-08-21 07:10:34","DDL1662101876","Deduction","C1437320","","84.61","9438.97"
"277","TCCL1002 - KUMAR CABLE NETWORK ( TNTDNTCCL1002 ) ","2023-08-21 07:10:34","DDL1662101886","Deduction","C1425806","","35.40","9403.57"
"278","TCCL1002 - KUMAR CABLE NETWORK ( TNTDNTCCL1002 ) ","2023-08-21 07:10:34","DDL1662101891","Deduction","C1425806","","84.61","9318.96"
"279","TCCL1002 - KUMAR CABLE NETWORK ( TNTDNTCCL1002 ) ","2023-08-21 07:10:34","DDL1662101896","Deduction","C0756480","","35.40","9283.56"
"280","TCCL1002 - KUMAR CABLE NETWORK ( TNTDNTCCL1002 ) ","2023-08-21 07:10:34","DDL1662101901","Deduction","C0756480","","84.61","9198.95"
"281","TCCL1002 - KUMAR CABLE NETWORK ( TNTDNTCCL1002 ) ","2023-08-21 07:10:34","DDL1662101911","Deduction","C0839779","","35.40","9163.55"
"282","TCCL1002 - KUMAR CABLE NETWORK ( TNTDNTCCL1002 ) ","2023-08-21 07:10:34","DDL1662101916","Deduction","C0839779","","84.61","9078.94"
"283","TCCL1002 - KUMAR CABLE NETWORK ( TNTDNTCCL1002 ) ","2023-08-21 07:10:34","DDL1662101921","Deduction","C1449004","","35.40","9043.54"
"284","TCCL1002 - KUMAR CABLE NETWORK ( TNTDNTCCL1002 ) ","2023-08-21 07:10:34","DDL1662101926","Deduction","C1449004","","84.61","8958.93"
"285","TCCL1002 - KUMAR CABLE NETWORK ( TNTDNTCCL1002 ) ","2023-08-21 07:10:34","DDL1662101931","Deduction","C5527136","","35.40","8923.53"
"286","TCCL1002 - KUMAR CABLE NETWORK ( TNTDNTCCL1002 ) ","2023-08-21 07:10:34","DDL1662101936","Deduction","C5527136","","84.61","8838.92"
"287","TCCL1002 - KUMAR CABLE NETWORK ( TNTDNTCCL1002 ) ","2023-08-21 07:10:35","DDL1662101941","Deduction","C1267818","","35.40","8803.52"
"288","TCCL1002 - KUMAR CABLE NETWORK ( TNTDNTCCL1002 ) ","2023-08-21 07:10:35","DDL1662101946","Deduction","C1267818","","84.61","8718.91"
"289","TCCL1002 - KUMAR CABLE NETWORK ( TNTDNTCCL1002 ) ","2023-08-21 07:10:35","DDL1662101951","Deduction","C10349797","","35.40","8683.51"
"290","TCCL1002 - KUMAR CABLE NETWORK ( TNTDNTCCL1002 ) ","2023-08-21 07:10:35","DDL1662101956","Deduction","C10349797","","84.61","8598.9"
"291","TCCL1002 - KUMAR CABLE NETWORK ( TNTDNTCCL1002 ) ","2023-08-21 07:10:35","DDL1662101961","Deduction","C0797263","","35.40","8563.5"
"292","TCCL1002 - KUMAR CABLE NETWORK ( TNTDNTCCL1002 ) ","2023-08-21 07:10:35","DDL1662101966","Deduction","C0797263","","84.61","8478.89"
"293","TCCL1002 - KUMAR CABLE NETWORK ( TNTDNTCCL1002 ) ","2023-08-21 07:10:35","DDL1662101971","Deduction","C1010622","","35.40","8443.49"
"294","TCCL1002 - KUMAR CABLE NETWORK ( TNTDNTCCL1002 ) ","2023-08-21 07:10:35","DDL1662101976","Deduction","C1010622","","84.61","8358.88"
"295","TCCL1002 - KUMAR CABLE NETWORK ( TNTDNTCCL1002 ) ","2023-08-21 07:10:35","DDL1662101981","Deduction","C7787231","","35.40","8323.48"
"296","TCCL1002 - KUMAR CABLE NETWORK ( TNTDNTCCL1002 ) ","2023-08-21 07:10:35","DDL1662101986","Deduction","C7787231","","84.61","8238.87"
"297","TCCL1002 - KUMAR CABLE NETWORK ( TNTDNTCCL1002 ) ","2023-08-21 07:10:35","DDL1662101991","Deduction","C5271559","","35.40","8203.47"
"298","TCCL1002 - KUMAR CABLE NETWORK ( TNTDNTCCL1002 ) ","2023-08-21 07:10:35","DDL1662101996","Deduction","C5271559","","84.61","8118.86"
"299","TCCL1002 - KUMAR CABLE NETWORK ( TNTDNTCCL1002 ) ","2023-08-21 07:10:35","DDL1662102001","Deduction","C0839942","","35.40","8083.46"
"300","TCCL1002 - KUMAR CABLE NETWORK ( TNTDNTCCL1002 ) ","2023-08-21 07:10:35","DDL1662102006","Deduction","C0839942","","84.61","7998.85"
"301","TCCL1002 - KUMAR CABLE NETWORK ( TNTDNTCCL1002 ) ","2023-08-21 07:10:35","DDL1662102011","Deduction","C1425740","","22.84","7976.01"
"302","TCCL1002 - KUMAR CABLE NETWORK ( TNTDNTCCL1002 ) ","2023-08-21 07:10:35","DDL1662102016","Deduction","C1425740","","54.59","7921.42"
"303","TCCL1002 - KUMAR CABLE NETWORK ( TNTDNTCCL1002 ) ","2023-08-21 07:10:35","DDL1662102026","Deduction","C0839767","","35.40","7886.02"
"304","TCCL1002 - KUMAR CABLE NETWORK ( TNTDNTCCL1002 ) ","2023-08-21 07:10:35","DDL1662102031","Deduction","C0839767","","84.61","7801.41"
"305","TCCL1002 - KUMAR CABLE NETWORK ( TNTDNTCCL1002 ) ","2023-08-21 07:10:35","DDL1662102036","Deduction","C2957470","","35.40","7766.01"
"306","TCCL1002 - KUMAR CABLE NETWORK ( TNTDNTCCL1002 ) ","2023-08-21 07:10:35","DDL1662102041","Deduction","C2957470","","84.61","7681.4"
"307","TCCL1002 - KUMAR CABLE NETWORK ( TNTDNTCCL1002 ) ","2023-08-21 07:10:35","DDL1662102051","Deduction","C6843192","","35.40","7646"
"308","TCCL1002 - KUMAR CABLE NETWORK ( TNTDNTCCL1002 ) ","2023-08-21 07:10:35","DDL1662102056","Deduction","C6843192","","84.61","7561.39"
"309","TCCL1002 - KUMAR CABLE NETWORK ( TNTDNTCCL1002 ) ","2023-08-21 07:10:35","DDL1662102061","Deduction","C2311055","","35.40","7525.99"
"310","TCCL1002 - KUMAR CABLE NETWORK ( TNTDNTCCL1002 ) ","2023-08-21 07:10:35","DDL1662102066","Deduction","C2311055","","47.78","7478.21"
"311","TCCL1002 - KUMAR CABLE NETWORK ( TNTDNTCCL1002 ) ","2023-08-21 07:10:35","DDL1662102071","Deduction","C1291195","","35.40","7442.81"
"312","TCCL1002 - KUMAR CABLE NETWORK ( TNTDNTCCL1002 ) ","2023-08-21 07:10:35","DDL1662102076","Deduction","C1291195","","84.61","7358.2"
"313","TCCL1002 - KUMAR CABLE NETWORK ( TNTDNTCCL1002 ) ","2023-08-21 07:10:35","DDL1662102081","Deduction","C0839950","","35.40","7322.8"
"314","TCCL1002 - KUMAR CABLE NETWORK ( TNTDNTCCL1002 ) ","2023-08-21 07:10:35","DDL1662102086","Deduction","C0839950","","84.61","7238.19"
"315","TCCL1002 - KUMAR CABLE NETWORK ( TNTDNTCCL1002 ) ","2023-08-21 07:10:36","DDL1662102091","Deduction","C2103869","","35.40","7202.79"
"316","TCCL1002 - KUMAR CABLE NETWORK ( TNTDNTCCL1002 ) ","2023-08-21 07:10:36","DDL1662102096","Deduction","C2103869","","84.61","7118.18"
"317","TCCL1002 - KUMAR CABLE NETWORK ( TNTDNTCCL1002 ) ","2023-08-21 07:10:36","DDL1662102101","Deduction","C10743576","","35.40","7082.78"
"318","TCCL1002 - KUMAR CABLE NETWORK ( TNTDNTCCL1002 ) ","2023-08-21 07:10:36","DDL1662102106","Deduction","C10743576","","84.61","6998.17"
"319","TCCL1002 - KUMAR CABLE NETWORK ( TNTDNTCCL1002 ) ","2023-08-21 07:10:36","DDL1662102111","Deduction","C2113643","","35.40","6962.77"
"320","TCCL1002 - KUMAR CABLE NETWORK ( TNTDNTCCL1002 ) ","2023-08-21 07:10:36","DDL1662102116","Deduction","C2113643","","84.61","6878.16"
"321","TCCL1002 - KUMAR CABLE NETWORK ( TNTDNTCCL1002 ) ","2023-08-21 07:10:36","DDL1662102121","Deduction","C7795023","","35.40","6842.76"
"322","TCCL1002 - KUMAR CABLE NETWORK ( TNTDNTCCL1002 ) ","2023-08-21 07:10:36","DDL1662102126","Deduction","C7795023","","84.61","6758.15"
"323","TCCL1002 - KUMAR CABLE NETWORK ( TNTDNTCCL1002 ) ","2023-08-21 07:10:36","DDL1662102131","Deduction","C1237754","","35.40","6722.75"
"324","TCCL1002 - KUMAR CABLE NETWORK ( TNTDNTCCL1002 ) ","2023-08-21 07:10:36","DDL1662102136","Deduction","C1237754","","84.61","6638.14"
"325","TCCL1002 - KUMAR CABLE NETWORK ( TNTDNTCCL1002 ) ","2023-08-21 07:10:36","DDL1662102141","Deduction","C1014398","","35.40","6602.74"
"326","TCCL1002 - KUMAR CABLE NETWORK ( TNTDNTCCL1002 ) ","2023-08-21 07:10:36","DDL1662102146","Deduction","C1014398","","164.79","6437.95"
"327","TCCL1002 - KUMAR CABLE NETWORK ( TNTDNTCCL1002 ) ","2023-08-21 07:10:36","DDL1662102151","Deduction","C1014398","","47.78","6390.17"
"328","TCCL1002 - KUMAR CABLE NETWORK ( TNTDNTCCL1002 ) ","2023-08-21 07:10:36","DDL1662102156","Deduction","C1014398","","6.38","6383.79"
"329","TCCL1002 - KUMAR CABLE NETWORK ( TNTDNTCCL1002 ) ","2023-08-21 07:10:36","DDL1662102161","Deduction","C1014398","","0.11","6383.68"
"330","TCCL1002 - KUMAR CABLE NETWORK ( TNTDNTCCL1002 ) ","2023-08-21 07:10:36","DDL1662102166","Deduction","C5092149","","35.40","6348.28"
"331","TCCL1002 - KUMAR CABLE NETWORK ( TNTDNTCCL1002 ) ","2023-08-21 07:10:36","DDL1662102171","Deduction","C5092149","","84.61","6263.67"
"332","TCCL1002 - KUMAR CABLE NETWORK ( TNTDNTCCL1002 ) ","2023-08-21 07:10:36","DDL1662102176","Deduction","C1495999","","35.40","6228.27"
"333","TCCL1002 - KUMAR CABLE NETWORK ( TNTDNTCCL1002 ) ","2023-08-21 07:10:36","DDL1662102181","Deduction","C1495999","","84.61","6143.66"
"334","TCCL1002 - KUMAR CABLE NETWORK ( TNTDNTCCL1002 ) ","2023-08-21 07:10:36","DDL1662102186","Deduction","C2551645","","35.40","6108.26"
"335","TCCL1002 - KUMAR CABLE NETWORK ( TNTDNTCCL1002 ) ","2023-08-21 07:10:36","DDL1662102191","Deduction","C2551645","","84.61","6023.65"
"336","TCCL1002 - KUMAR CABLE NETWORK ( TNTDNTCCL1002 ) ","2023-08-21 07:10:39","DDL1662102286","Deduction","C1425705","","35.40","5988.25"
"337","TCCL1002 - KUMAR CABLE NETWORK ( TNTDNTCCL1002 ) ","2023-08-21 07:10:39","DDL1662102291","Deduction","C1425705","","84.61","5903.64"
"338","TCCL1002 - KUMAR CABLE NETWORK ( TNTDNTCCL1002 ) ","2023-08-21 07:10:39","DDL1662102296","Deduction","C1468098","","35.40","5868.24"
"339","TCCL1002 - KUMAR CABLE NETWORK ( TNTDNTCCL1002 ) ","2023-08-21 07:10:39","DDL1662102301","Deduction","C1468098","","84.61","5783.63"
"340","TCCL1002 - KUMAR CABLE NETWORK ( TNTDNTCCL1002 ) ","2023-08-21 07:10:39","DDL1662102306","Deduction","C5994050","","35.40","5748.23"
"341","TCCL1002 - KUMAR CABLE NETWORK ( TNTDNTCCL1002 ) ","2023-08-21 07:10:39","DDL1662102311","Deduction","C5994050","","84.61","5663.62"
"342","TCCL1002 - KUMAR CABLE NETWORK ( TNTDNTCCL1002 ) ","2023-08-21 07:10:40","DDL1662102316","Deduction","C6063433","","35.40","5628.22"
"343","TCCL1002 - KUMAR CABLE NETWORK ( TNTDNTCCL1002 ) ","2023-08-21 07:10:40","DDL1662102321","Deduction","C6063433","","84.61","5543.61"
"344","TCCL1002 - KUMAR CABLE NETWORK ( TNTDNTCCL1002 ) ","2023-08-21 07:10:40","DDL1662102331","Deduction","C9927995","","35.40","5508.21"
"345","TCCL1002 - KUMAR CABLE NETWORK ( TNTDNTCCL1002 ) ","2023-08-21 07:10:40","DDL1662102336","Deduction","C9927995","","84.61","5423.6"
"346","TCCL1002 - KUMAR CABLE NETWORK ( TNTDNTCCL1002 ) ","2023-08-21 07:10:40","DDL1662102341","Deduction","C2566372","","35.40","5388.2"
"347","TCCL1002 - KUMAR CABLE NETWORK ( TNTDNTCCL1002 ) ","2023-08-21 07:10:40","DDL1662102346","Deduction","C2566372","","84.61","5303.59"
"348","TCCL1002 - KUMAR CABLE NETWORK ( TNTDNTCCL1002 ) ","2023-08-21 07:10:40","DDL1662102351","Deduction","C12157796","","35.40","5268.19"
"349","TCCL1002 - KUMAR CABLE NETWORK ( TNTDNTCCL1002 ) ","2023-08-21 07:10:40","DDL1662102356","Deduction","C12157796","","84.61","5183.58"
"350","TCCL1002 - KUMAR CABLE NETWORK ( TNTDNTCCL1002 ) ","2023-08-21 07:10:40","DDL1662102361","Deduction","C1495995","","35.40","5148.18"
"351","TCCL1002 - KUMAR CABLE NETWORK ( TNTDNTCCL1002 ) ","2023-08-21 07:10:40","DDL1662102366","Deduction","C1495995","","84.61","5063.57"
"352","TCCL1002 - KUMAR CABLE NETWORK ( TNTDNTCCL1002 ) ","2023-08-21 07:10:40","DDL1662102386","Deduction","C1430868","","35.40","5028.17"
"353","TCCL1002 - KUMAR CABLE NETWORK ( TNTDNTCCL1002 ) ","2023-08-21 07:10:40","DDL1662102391","Deduction","C1430868","","84.61","4943.56"
"354","TCCL1002 - KUMAR CABLE NETWORK ( TNTDNTCCL1002 ) ","2023-08-21 07:10:40","DDL1662102396","Deduction","C1554614","","35.40","4908.16"
"355","TCCL1002 - KUMAR CABLE NETWORK ( TNTDNTCCL1002 ) ","2023-08-21 07:10:40","DDL1662102401","Deduction","C1554614","","84.61","4823.55"
"356","TCCL1002 - KUMAR CABLE NETWORK ( TNTDNTCCL1002 ) ","2023-08-21 07:10:40","DDL1662102406","Deduction","C1237951","","35.40","4788.15"
"357","TCCL1002 - KUMAR CABLE NETWORK ( TNTDNTCCL1002 ) ","2023-08-21 07:10:40","DDL1662102411","Deduction","C1237951","","84.61","4703.54"
"358","TCCL1002 - KUMAR CABLE NETWORK ( TNTDNTCCL1002 ) ","2023-08-21 07:10:40","DDL1662102421","Deduction","C6115333","","35.40","4668.14"
"359","TCCL1002 - KUMAR CABLE NETWORK ( TNTDNTCCL1002 ) ","2023-08-21 07:10:40","DDL1662102426","Deduction","C6115333","","84.61","4583.53"
"360","TCCL1002 - KUMAR CABLE NETWORK ( TNTDNTCCL1002 ) ","2023-08-21 07:10:40","DDL1662102431","Deduction","C1238016","","35.40","4548.13"
"361","TCCL1002 - KUMAR CABLE NETWORK ( TNTDNTCCL1002 ) ","2023-08-21 07:10:40","DDL1662102436","Deduction","C1238016","","84.61","4463.52"
"362","TCCL1002 - KUMAR CABLE NETWORK ( TNTDNTCCL1002 ) ","2023-08-21 07:10:40","DDL1662102441","Deduction","C5076993","","35.40","4428.12"
"363","TCCL1002 - KUMAR CABLE NETWORK ( TNTDNTCCL1002 ) ","2023-08-21 07:10:40","DDL1662102446","Deduction","C5076993","","84.61","4343.51"
"364","TCCL1002 - KUMAR CABLE NETWORK ( TNTDNTCCL1002 ) ","2023-08-21 07:10:40","DDL1662102451","Deduction","C1432094","","35.40","4308.11"
"365","TCCL1002 - KUMAR CABLE NETWORK ( TNTDNTCCL1002 ) ","2023-08-21 07:10:40","DDL1662102456","Deduction","C1432094","","84.61","4223.5"
"366","TCCL1002 - KUMAR CABLE NETWORK ( TNTDNTCCL1002 ) ","2023-08-21 07:10:40","DDL1662102461","Deduction","C1448871","","35.40","4188.1"
"367","TCCL1002 - KUMAR CABLE NETWORK ( TNTDNTCCL1002 ) ","2023-08-21 07:10:40","DDL1662102466","Deduction","C1448871","","84.61","4103.49"
"368","TCCL1002 - KUMAR CABLE NETWORK ( TNTDNTCCL1002 ) ","2023-08-21 07:10:40","DDL1662102471","Deduction","C5945921","","35.40","4068.09"
"369","TCCL1002 - KUMAR CABLE NETWORK ( TNTDNTCCL1002 ) ","2023-08-21 07:10:40","DDL1662102476","Deduction","C5945921","","84.61","3983.48"
"370","TCCL1002 - KUMAR CABLE NETWORK ( TNTDNTCCL1002 ) ","2023-08-21 07:10:40","DDL1662102481","Deduction","C1432099","","35.40","3948.08"
"371","TCCL1002 - KUMAR CABLE NETWORK ( TNTDNTCCL1002 ) ","2023-08-21 07:10:40","DDL1662102486","Deduction","C1432099","","84.61","3863.47"
"372","TCCL1002 - KUMAR CABLE NETWORK ( TNTDNTCCL1002 ) ","2023-08-21 07:10:41","DDL1662102491","Deduction","C12157930","","35.40","3828.07"
"373","TCCL1002 - KUMAR CABLE NETWORK ( TNTDNTCCL1002 ) ","2023-08-21 07:10:41","DDL1662102496","Deduction","C12157930","","84.61","3743.46"
"374","TCCL1002 - KUMAR CABLE NETWORK ( TNTDNTCCL1002 ) ","2023-08-21 07:10:41","DDL1662102501","Deduction","C1676810","","35.40","3708.06"
"375","TCCL1002 - KUMAR CABLE NETWORK ( TNTDNTCCL1002 ) ","2023-08-21 07:10:41","DDL1662102506","Deduction","C1676810","","84.61","3623.45"
"376","TCCL1002 - KUMAR CABLE NETWORK ( TNTDNTCCL1002 ) ","2023-08-21 07:10:41","DDL1662102521","Deduction","C1291194","","35.40","3588.05"
"377","TCCL1002 - KUMAR CABLE NETWORK ( TNTDNTCCL1002 ) ","2023-08-21 07:10:41","DDL1662102526","Deduction","C1291194","","84.61","3503.44"
"378","TCCL1002 - KUMAR CABLE NETWORK ( TNTDNTCCL1002 ) ","2023-08-21 09:18:12","DDL1662308148","Deduction","C1468097","","12.56","3490.88"
"379","TCCL1002 - KUMAR CABLE NETWORK ( TNTDNTCCL1002 ) ","2023-08-21 09:18:12","DDL1662308153","Deduction","C1468097","","30.03","3460.85"
"380","TCCL1002 - KUMAR CABLE NETWORK ( TNTDNTCCL1002 ) ","2023-08-21 09:19:05","DDL1662308558","Deduction","C1432096","","12.56","3448.29"
"381","TCCL1002 - KUMAR CABLE NETWORK ( TNTDNTCCL1002 ) ","2023-08-21 09:19:05","DDL1662308563","Deduction","C1432096","","30.03","3418.26"
"382","TCCL1002 - KUMAR CABLE NETWORK ( TNTDNTCCL1002 ) ","2023-08-21 20:23:49","DDL1664617357","Deduction","C0769247","","12.56","3405.7"
"383","TCCL1002 - KUMAR CABLE NETWORK ( TNTDNTCCL1002 ) ","2023-08-21 20:23:49","DDL1664617362","Deduction","C0769247","","30.03","3375.67"
"384","TCCL1002 - KUMAR CABLE NETWORK ( TNTDNTCCL1002 ) ","2023-08-23 19:20:47","DDL1670905418","Deduction","C4300548","","10.28","3365.39"
"385","TCCL1002 - KUMAR CABLE NETWORK ( TNTDNTCCL1002 ) ","2023-08-23 19:20:47","DDL1670905423","Deduction","C4300548","","24.56","3340.83"
"386","TCCL1002 - KUMAR CABLE NETWORK ( TNTDNTCCL1002 ) ","2023-08-31 21:30:37","DDL1680261349","Deduction","C1432102","","2.74","3338.09"
"387","TCCL1002 - KUMAR CABLE NETWORK ( TNTDNTCCL1002 ) ","2023-08-31 21:30:37","DDL1680261354","Deduction","C1432102","","1.14","3336.95"
"388","TCCL1002 - KUMAR CABLE NETWORK ( TNTDNTCCL1002 ) ","2023-09-09 15:29:51","TR18378755","Adjustment (credit note for september-2023 life time stb ncf bill(1*35.40)) ","","35.40","","3372.35"
"389","TCCL1002 - KUMAR CABLE NETWORK ( TNTDNTCCL1002 ) ","2023-09-09 15:45:04","DDL1682092153","Deduction","C5714740","","35.40","3336.95"
"390","TCCL1002 - KUMAR CABLE NETWORK ( TNTDNTCCL1002 ) ","2023-09-13 14:01:12","DDL1684059071","Deduction","C2253859","","50.76","3286.19"
"391","TCCL1002 - KUMAR CABLE NETWORK ( TNTDNTCCL1002 ) ","2023-09-13 14:01:12","DDL1684059076","Deduction","C2253859","","21.24","3264.95"
"392","TCCL1002 - KUMAR CABLE NETWORK ( TNTDNTCCL1002 ) ","2023-09-17 20:03:30","DDL1687883408","Deduction","C12157930","","20.06","3244.89"
"393","TCCL1002 - KUMAR CABLE NETWORK ( TNTDNTCCL1002 ) ","2023-09-17 20:03:30","DDL1687883413","Deduction","C12157930","","47.95","3196.94"
"394","TCCL1002 - KUMAR CABLE NETWORK ( TNTDNTCCL1002 ) ","2023-09-18 18:30:51","DDL1688929545","Deduction","C1468097","","14.16","3182.78"
"395","TCCL1002 - KUMAR CABLE NETWORK ( TNTDNTCCL1002 ) ","2023-09-18 18:30:51","DDL1688929550","Deduction","C1468097","","33.84","3148.94"
"396","TCCL1002 - KUMAR CABLE NETWORK ( TNTDNTCCL1002 ) ","2023-09-18 18:30:51","DDL1688929555","Deduction","C1468097","","21.24","3127.7"
"397","TCCL1002 - KUMAR CABLE NETWORK ( TNTDNTCCL1002 ) ","2023-09-18 18:30:51","DDL1688929560","Deduction","C1468097","","50.76","3076.94"
"398","TCCL1002 - KUMAR CABLE NETWORK ( TNTDNTCCL1002 ) ","2023-09-18 18:50:27","DDL1688953909","Deduction","C12371501","","14.16","3062.78"
"399","TCCL1002 - KUMAR CABLE NETWORK ( TNTDNTCCL1002 ) ","2023-09-18 18:50:27","DDL1688953919","Deduction","C12371501","","33.84","3028.94"
"400","TCCL1002 - KUMAR CABLE NETWORK ( TNTDNTCCL1002 ) ","2023-09-18 18:50:27","DDL1688953924","Deduction","C12371501","","21.24","3007.7"
"401","TCCL1002 - KUMAR CABLE NETWORK ( TNTDNTCCL1002 ) ","2023-09-18 18:50:27","DDL1688953929","Deduction","C12371501","","50.76","2956.94"
"402","TCCL1002 - KUMAR CABLE NETWORK ( TNTDNTCCL1002 ) ","2023-09-18 19:00:42","TR18521152","Normal Deposit (Lco Amount Deposited from Lco Portal. EASEBUZZ payment with Ref No- RC_3na4PN) ","","1000.00","","3956.94"
"403","TCCL1002 - KUMAR CABLE NETWORK ( TNTDNTCCL1002 ) ","2023-09-18 19:02:18","DDL1688975208","Deduction","C5076993","","14.16","3942.78"
"404","TCCL1002 - KUMAR CABLE NETWORK ( TNTDNTCCL1002 ) ","2023-09-18 19:02:18","DDL1688975213","Deduction","C5076993","","33.84","3908.94"
"405","TCCL1002 - KUMAR CABLE NETWORK ( TNTDNTCCL1002 ) ","2023-09-18 19:02:18","DDL1688975218","Deduction","C5076993","","21.24","3887.7"
"406","TCCL1002 - KUMAR CABLE NETWORK ( TNTDNTCCL1002 ) ","2023-09-18 19:02:18","DDL1688975223","Deduction","C5076993","","50.76","3836.94"
"407","TCCL1002 - KUMAR CABLE NETWORK ( TNTDNTCCL1002 ) ","2023-09-18 19:12:50","DDL1688991699","Deduction","C5527136","","14.16","3822.78"
"408","TCCL1002 - KUMAR CABLE NETWORK ( TNTDNTCCL1002 ) ","2023-09-18 19:12:50","DDL1688991704","Deduction","C5527136","","33.84","3788.94"
"409","TCCL1002 - KUMAR CABLE NETWORK ( TNTDNTCCL1002 ) ","2023-09-18 19:12:50","DDL1688991709","Deduction","C5527136","","21.24","3767.7"
"410","TCCL1002 - KUMAR CABLE NETWORK ( TNTDNTCCL1002 ) ","2023-09-18 19:12:50","DDL1688991714","Deduction","C5527136","","50.76","3716.94"
"411","TCCL1002 - KUMAR CABLE NETWORK ( TNTDNTCCL1002 ) ","2023-09-18 19:19:11","DDL1689000089","Deduction","C0839767","","14.16","3702.78"
"412","TCCL1002 - KUMAR CABLE NETWORK ( TNTDNTCCL1002 ) ","2023-09-18 19:19:11","DDL1689000094","Deduction","C0839767","","33.84","3668.94"
"413","TCCL1002 - KUMAR CABLE NETWORK ( TNTDNTCCL1002 ) ","2023-09-18 19:19:11","DDL1689000099","Deduction","C0839767","","21.24","3647.7"
"414","TCCL1002 - KUMAR CABLE NETWORK ( TNTDNTCCL1002 ) ","2023-09-18 19:19:11","DDL1689000104","Deduction","C0839767","","50.76","3596.94"
"415","TCCL1002 - KUMAR CABLE NETWORK ( TNTDNTCCL1002 ) ","2023-09-18 19:21:35","DDL1689007062","Deduction","C12157930","","15.34","3581.6"
"416","TCCL1002 - KUMAR CABLE NETWORK ( TNTDNTCCL1002 ) ","2023-09-18 19:21:35","DDL1689007067","Deduction","C12157930","","36.67","3544.93"
"417","TCCL1002 - KUMAR CABLE NETWORK ( TNTDNTCCL1002 ) ","2023-09-18 20:36:42","DDL1689134391","Deduction","C1432090","","15.34","3529.59"
"418","TCCL1002 - KUMAR CABLE NETWORK ( TNTDNTCCL1002 ) ","2023-09-18 20:36:42","DDL1689134396","Deduction","C1432090","","36.67","3492.92"
"419","TCCL1002 - KUMAR CABLE NETWORK ( TNTDNTCCL1002 ) ","2023-09-19 09:05:05","DDL1689587697","Deduction","C0756480","","14.16","3478.76"
"420","TCCL1002 - KUMAR CABLE NETWORK ( TNTDNTCCL1002 ) ","2023-09-19 09:05:05","DDL1689587702","Deduction","C0756480","","33.84","3444.92"
"421","TCCL1002 - KUMAR CABLE NETWORK ( TNTDNTCCL1002 ) ","2023-09-19 09:05:05","DDL1689587707","Deduction","C0756480","","21.24","3423.68"
"422","TCCL1002 - KUMAR CABLE NETWORK ( TNTDNTCCL1002 ) ","2023-09-19 09:05:05","DDL1689587712","Deduction","C0756480","","50.76","3372.92"
"423","TCCL1002 - KUMAR CABLE NETWORK ( TNTDNTCCL1002 ) ","2023-09-19 20:12:36","DDL1691981511","Deduction","C7346395","","14.16","3358.76"
"424","TCCL1002 - KUMAR CABLE NETWORK ( TNTDNTCCL1002 ) ","2023-09-19 20:12:36","DDL1691981521","Deduction","C7346395","","33.84","3324.92"
"425","TCCL1002 - KUMAR CABLE NETWORK ( TNTDNTCCL1002 ) ","2023-09-19 20:12:36","DDL1691981531","Deduction","C7346395","","21.24","3303.68"
"426","TCCL1002 - KUMAR CABLE NETWORK ( TNTDNTCCL1002 ) ","2023-09-19 20:12:36","DDL1691981536","Deduction","C7346395","","50.76","3252.92"
"427","TCCL1002 - KUMAR CABLE NETWORK ( TNTDNTCCL1002 ) ","2023-09-19 20:17:25","DDL1692011919","Deduction","C1496002","","14.16","3238.76"
"428","TCCL1002 - KUMAR CABLE NETWORK ( TNTDNTCCL1002 ) ","2023-09-19 20:17:25","DDL1692011924","Deduction","C1496002","","33.84","3204.92"
"429","TCCL1002 - KUMAR CABLE NETWORK ( TNTDNTCCL1002 ) ","2023-09-19 20:17:25","DDL1692011934","Deduction","C1496002","","21.24","3183.68"
"430","TCCL1002 - KUMAR CABLE NETWORK ( TNTDNTCCL1002 ) ","2023-09-19 20:17:25","DDL1692011939","Deduction","C1496002","","50.76","3132.92"
"431","TCCL1002 - KUMAR CABLE NETWORK ( TNTDNTCCL1002 ) ","2023-09-19 21:48:21","DDL1692508564","Deduction","C4083997","","14.16","3118.76"
"432","TCCL1002 - KUMAR CABLE NETWORK ( TNTDNTCCL1002 ) ","2023-09-19 21:48:21","DDL1692508569","Deduction","C4083997","","33.84","3084.92"
"433","TCCL1002 - KUMAR CABLE NETWORK ( TNTDNTCCL1002 ) ","2023-09-19 22:03:17","DDL1692604263","Deduction","C1554615","","14.16","3070.76"
"434","TCCL1002 - KUMAR CABLE NETWORK ( TNTDNTCCL1002 ) ","2023-09-19 22:03:17","DDL1692604268","Deduction","C1554615","","33.84","3036.92"
"435","TCCL1002 - KUMAR CABLE NETWORK ( TNTDNTCCL1002 ) ","2023-09-19 22:03:17","DDL1692604273","Deduction","C1554615","","21.24","3015.68"
"436","TCCL1002 - KUMAR CABLE NETWORK ( TNTDNTCCL1002 ) ","2023-09-19 22:03:17","DDL1692604278","Deduction","C1554615","","50.76","2964.92"
"437","TCCL1002 - KUMAR CABLE NETWORK ( TNTDNTCCL1002 ) ","2023-09-20 16:41:11","TR18562035","Normal Deposit (Lco Amount Deposited from Lco Portal. EASEBUZZ payment with Ref No- RC_awdzkg) ","","1000.00","","3964.92"
"438","TCCL1002 - KUMAR CABLE NETWORK ( TNTDNTCCL1002 ) ","2023-09-20 16:43:12","DDL1695734272","Deduction","C8916676","","12.98","3951.94"
"439","TCCL1002 - KUMAR CABLE NETWORK ( TNTDNTCCL1002 ) ","2023-09-20 16:43:12","DDL1695734277","Deduction","C8916676","","31.03","3920.91"
"440","TCCL1002 - KUMAR CABLE NETWORK ( TNTDNTCCL1002 ) ","2023-09-20 16:43:12","DDL1695734282","Deduction","C8916676","","21.24","3899.67"
"441","TCCL1002 - KUMAR CABLE NETWORK ( TNTDNTCCL1002 ) ","2023-09-20 16:43:12","DDL1695734287","Deduction","C8916676","","50.76","3848.91"
"442","TCCL1002 - KUMAR CABLE NETWORK ( TNTDNTCCL1002 ) ","2023-09-20 17:02:16","DDL1695800424","Deduction","C1459282","","12.98","3835.93"
"443","TCCL1002 - KUMAR CABLE NETWORK ( TNTDNTCCL1002 ) ","2023-09-20 17:02:16","DDL1695800429","Deduction","C1459282","","31.03","3804.9"
"444","TCCL1002 - KUMAR CABLE NETWORK ( TNTDNTCCL1002 ) ","2023-09-20 17:02:16","DDL1695800434","Deduction","C1459282","","21.24","3783.66"
"445","TCCL1002 - KUMAR CABLE NETWORK ( TNTDNTCCL1002 ) ","2023-09-20 17:02:16","DDL1695800439","Deduction","C1459282","","50.76","3732.9"
"446","TCCL1002 - KUMAR CABLE NETWORK ( TNTDNTCCL1002 ) ","2023-09-20 22:00:26","TR18577700","Normal Deposit (Lco Amount Deposited from Lco Portal. Paytm payment with Ref No- RC_kY2bz7) ","","5000.00","","8732.9"
"447","TCCL1002 - KUMAR CABLE NETWORK ( TNTDNTCCL1002 ) ","2023-09-20 22:03:53","TR18577890","Normal Deposit (Lco Amount Deposited from Lco Portal. EASEBUZZ payment with Ref No- RC_R7kmAf) ","","15000.00","","23732.9"
"448","TCCL1002 - KUMAR CABLE NETWORK ( TNTDNTCCL1002 ) ","2023-09-21 01:32:23","DDL1698259250","Deduction","C0757509","","35.40","23697.5"
"449","TCCL1002 - KUMAR CABLE NETWORK ( TNTDNTCCL1002 ) ","2023-09-21 01:32:23","DDL1698259255","Deduction","C0757509","","84.61","23612.89"
"450","TCCL1002 - KUMAR CABLE NETWORK ( TNTDNTCCL1002 ) ","2023-09-21 01:32:23","DDL1698259275","Deduction","C1432101","","35.40","23577.49"
"451","TCCL1002 - KUMAR CABLE NETWORK ( TNTDNTCCL1002 ) ","2023-09-21 01:32:23","DDL1698259280","Deduction","C1432101","","84.61","23492.88"
"452","TCCL1002 - KUMAR CABLE NETWORK ( TNTDNTCCL1002 ) ","2023-09-21 01:32:23","DDL1698259305","Deduction","C3896312","","35.40","23457.48"
"453","TCCL1002 - KUMAR CABLE NETWORK ( TNTDNTCCL1002 ) ","2023-09-21 01:32:23","DDL1698259310","Deduction","C3896312","","84.61","23372.87"
"454","TCCL1002 - KUMAR CABLE NETWORK ( TNTDNTCCL1002 ) ","2023-09-21 01:32:23","DDL1698259315","Deduction","C1237806","","28.32","23344.55"
"455","TCCL1002 - KUMAR CABLE NETWORK ( TNTDNTCCL1002 ) ","2023-09-21 01:32:23","DDL1698259320","Deduction","C1237806","","67.69","23276.86"
"456","TCCL1002 - KUMAR CABLE NETWORK ( TNTDNTCCL1002 ) ","2023-09-21 01:32:23","DDL1698259360","Deduction","C1238666","","35.40","23241.46"
"457","TCCL1002 - KUMAR CABLE NETWORK ( TNTDNTCCL1002 ) ","2023-09-21 01:32:23","DDL1698259365","Deduction","C1238666","","84.61","23156.85"
"458","TCCL1002 - KUMAR CABLE NETWORK ( TNTDNTCCL1002 ) ","2023-09-21 01:32:23","DDL1698259375","Deduction","C2227396","","35.40","23121.45"
"459","TCCL1002 - KUMAR CABLE NETWORK ( TNTDNTCCL1002 ) ","2023-09-21 01:32:23","DDL1698259380","Deduction","C2227396","","84.61","23036.84"
"460","TCCL1002 - KUMAR CABLE NETWORK ( TNTDNTCCL1002 ) ","2023-09-21 01:32:24","DDL1698259400","Deduction","C1437253","","35.40","23001.44"
"461","TCCL1002 - KUMAR CABLE NETWORK ( TNTDNTCCL1002 ) ","2023-09-21 01:32:24","DDL1698259405","Deduction","C1437253","","84.61","22916.83"
"462","TCCL1002 - KUMAR CABLE NETWORK ( TNTDNTCCL1002 ) ","2023-09-21 01:32:24","DDL1698259425","Deduction","C6267661","","35.40","22881.43"
"463","TCCL1002 - KUMAR CABLE NETWORK ( TNTDNTCCL1002 ) ","2023-09-21 01:32:24","DDL1698259430","Deduction","C6267661","","84.61","22796.82"
"464","TCCL1002 - KUMAR CABLE NETWORK ( TNTDNTCCL1002 ) ","2023-09-21 01:32:24","DDL1698259450","Deduction","C1468102","","35.40","22761.42"
"465","TCCL1002 - KUMAR CABLE NETWORK ( TNTDNTCCL1002 ) ","2023-09-21 01:32:24","DDL1698259455","Deduction","C1468102","","84.61","22676.81"
"466","TCCL1002 - KUMAR CABLE NETWORK ( TNTDNTCCL1002 ) ","2023-09-21 01:32:24","DDL1698259490","Deduction","C1427120","","35.40","22641.41"
"467","TCCL1002 - KUMAR CABLE NETWORK ( TNTDNTCCL1002 ) ","2023-09-21 01:32:24","DDL1698259495","Deduction","C1427120","","84.61","22556.8"
"468","TCCL1002 - KUMAR CABLE NETWORK ( TNTDNTCCL1002 ) ","2023-09-21 01:32:24","DDL1698259505","Deduction","C1554612","","35.40","22521.4"
"469","TCCL1002 - KUMAR CABLE NETWORK ( TNTDNTCCL1002 ) ","2023-09-21 01:32:24","DDL1698259510","Deduction","C1554612","","84.61","22436.79"
"470","TCCL1002 - KUMAR CABLE NETWORK ( TNTDNTCCL1002 ) ","2023-09-21 01:32:24","DDL1698259530","Deduction","C5684330","","35.40","22401.39"
"471","TCCL1002 - KUMAR CABLE NETWORK ( TNTDNTCCL1002 ) ","2023-09-21 01:32:24","DDL1698259535","Deduction","C5684330","","84.61","22316.78"
"472","TCCL1002 - KUMAR CABLE NETWORK ( TNTDNTCCL1002 ) ","2023-09-21 01:32:24","DDL1698259555","Deduction","C1693303","","35.40","22281.38"
"473","TCCL1002 - KUMAR CABLE NETWORK ( TNTDNTCCL1002 ) ","2023-09-21 01:32:24","DDL1698259560","Deduction","C1693303","","84.61","22196.77"
"474","TCCL1002 - KUMAR CABLE NETWORK ( TNTDNTCCL1002 ) ","2023-09-21 01:32:24","DDL1698259575","Deduction","C2161413","","35.40","22161.37"
"475","TCCL1002 - KUMAR CABLE NETWORK ( TNTDNTCCL1002 ) ","2023-09-21 01:32:24","DDL1698259580","Deduction","C2161413","","84.61","22076.76"
"476","TCCL1002 - KUMAR CABLE NETWORK ( TNTDNTCCL1002 ) ","2023-09-21 01:32:24","DDL1698259595","Deduction","C6287282","","35.40","22041.36"
"477","TCCL1002 - KUMAR CABLE NETWORK ( TNTDNTCCL1002 ) ","2023-09-21 01:32:24","DDL1698259600","Deduction","C6287282","","84.61","21956.75"
"478","TCCL1002 - KUMAR CABLE NETWORK ( TNTDNTCCL1002 ) ","2023-09-21 01:32:24","DDL1698259620","Deduction","C1426984","","35.40","21921.35"
"479","TCCL1002 - KUMAR CABLE NETWORK ( TNTDNTCCL1002 ) ","2023-09-21 01:32:24","DDL1698259625","Deduction","C1426984","","84.61","21836.74"
"480","TCCL1002 - KUMAR CABLE NETWORK ( TNTDNTCCL1002 ) ","2023-09-21 01:32:24","DDL1698259630","Deduction","C1426984","","20.18","21816.56"
"481","TCCL1002 - KUMAR CABLE NETWORK ( TNTDNTCCL1002 ) ","2023-09-21 01:32:24","DDL1698259635","Deduction","C1426984","","20.18","21796.38"
"482","TCCL1002 - KUMAR CABLE NETWORK ( TNTDNTCCL1002 ) ","2023-09-21 01:32:24","DDL1698259640","Deduction","C1426984","","20.18","21776.2"
"483","TCCL1002 - KUMAR CABLE NETWORK ( TNTDNTCCL1002 ) ","2023-09-21 01:32:25","DDL1698259665","Deduction","C1291196","","35.40","21740.8"
"484","TCCL1002 - KUMAR CABLE NETWORK ( TNTDNTCCL1002 ) ","2023-09-21 01:32:25","DDL1698259670","Deduction","C1291196","","84.61","21656.19"
"485","TCCL1002 - KUMAR CABLE NETWORK ( TNTDNTCCL1002 ) ","2023-09-21 01:32:25","DDL1698259705","Deduction","C2558795","","35.40","21620.79"
"486","TCCL1002 - KUMAR CABLE NETWORK ( TNTDNTCCL1002 ) ","2023-09-21 01:32:25","DDL1698259710","Deduction","C2558795","","84.61","21536.18"
"487","TCCL1002 - KUMAR CABLE NETWORK ( TNTDNTCCL1002 ) ","2023-09-21 01:32:25","DDL1698259740","Deduction","C5575416","","35.40","21500.78"
"488","TCCL1002 - KUMAR CABLE NETWORK ( TNTDNTCCL1002 ) ","2023-09-21 01:32:25","DDL1698259745","Deduction","C5575416","","84.61","21416.17"
"489","TCCL1002 - KUMAR CABLE NETWORK ( TNTDNTCCL1002 ) ","2023-09-21 01:32:25","DDL1698259765","Deduction","C1437301","","35.40","21380.77"
"490","TCCL1002 - KUMAR CABLE NETWORK ( TNTDNTCCL1002 ) ","2023-09-21 01:32:25","DDL1698259770","Deduction","C1437301","","84.61","21296.16"
"491","TCCL1002 - KUMAR CABLE NETWORK ( TNTDNTCCL1002 ) ","2023-09-21 01:32:25","DDL1698259785","Deduction","C1992670","","35.40","21260.76"
"492","TCCL1002 - KUMAR CABLE NETWORK ( TNTDNTCCL1002 ) ","2023-09-21 01:32:25","DDL1698259790","Deduction","C1992670","","84.61","21176.15"
"493","TCCL1002 - KUMAR CABLE NETWORK ( TNTDNTCCL1002 ) ","2023-09-21 01:32:25","DDL1698259820","Deduction","C0798097","","35.40","21140.75"
"494","TCCL1002 - KUMAR CABLE NETWORK ( TNTDNTCCL1002 ) ","2023-09-21 01:32:25","DDL1698259825","Deduction","C0798097","","84.61","21056.14"
"495","TCCL1002 - KUMAR CABLE NETWORK ( TNTDNTCCL1002 ) ","2023-09-21 01:32:25","DDL1698259850","Deduction","C1693300","","35.40","21020.74"
"496","TCCL1002 - KUMAR CABLE NETWORK ( TNTDNTCCL1002 ) ","2023-09-21 01:32:25","DDL1698259855","Deduction","C1693300","","84.61","20936.13"
"497","TCCL1002 - KUMAR CABLE NETWORK ( TNTDNTCCL1002 ) ","2023-09-21 01:32:25","DDL1698259880","Deduction","C1087161","","35.40","20900.73"
"498","TCCL1002 - KUMAR CABLE NETWORK ( TNTDNTCCL1002 ) ","2023-09-21 01:32:25","DDL1698259885","Deduction","C1087161","","124.60","20776.13"
"499","TCCL1002 - KUMAR CABLE NETWORK ( TNTDNTCCL1002 ) ","2023-09-21 01:32:25","DDL1698259895","Deduction","C3379807","","35.40","20740.73"
"500","TCCL1002 - KUMAR CABLE NETWORK ( TNTDNTCCL1002 ) ","2023-09-21 01:32:25","DDL1698259900","Deduction","C3379807","","84.61","20656.12"
"501","TCCL1002 - KUMAR CABLE NETWORK ( TNTDNTCCL1002 ) ","2023-09-21 01:32:25","DDL1698259925","Deduction","C7395841","","35.40","20620.72"
"502","TCCL1002 - KUMAR CABLE NETWORK ( TNTDNTCCL1002 ) ","2023-09-21 01:32:25","DDL1698259930","Deduction","C7395841","","84.61","20536.11"
"503","TCCL1002 - KUMAR CABLE NETWORK ( TNTDNTCCL1002 ) ","2023-09-21 01:32:26","DDL1698259935","Deduction","C2051654","","35.40","20500.71"
"504","TCCL1002 - KUMAR CABLE NETWORK ( TNTDNTCCL1002 ) ","2023-09-21 01:32:26","DDL1698259940","Deduction","C2051654","","84.61","20416.1"
"505","TCCL1002 - KUMAR CABLE NETWORK ( TNTDNTCCL1002 ) ","2023-09-21 01:32:26","DDL1698259970","Deduction","C1426720","","35.40","20380.7"
"506","TCCL1002 - KUMAR CABLE NETWORK ( TNTDNTCCL1002 ) ","2023-09-21 01:32:26","DDL1698259975","Deduction","C1426720","","84.61","20296.09"
"507","TCCL1002 - KUMAR CABLE NETWORK ( TNTDNTCCL1002 ) ","2023-09-21 01:32:26","DDL1698259990","Deduction","C1425593","","35.40","20260.69"
"508","TCCL1002 - KUMAR CABLE NETWORK ( TNTDNTCCL1002 ) ","2023-09-21 01:32:26","DDL1698259995","Deduction","C1425593","","84.61","20176.08"
"509","TCCL1002 - KUMAR CABLE NETWORK ( TNTDNTCCL1002 ) ","2023-09-21 01:32:26","DDL1698260015","Deduction","C1459332","","35.40","20140.68"
"510","TCCL1002 - KUMAR CABLE NETWORK ( TNTDNTCCL1002 ) ","2023-09-21 01:32:26","DDL1698260020","Deduction","C1459332","","84.61","20056.07"
"511","TCCL1002 - KUMAR CABLE NETWORK ( TNTDNTCCL1002 ) ","2023-09-21 01:32:26","DDL1698260030","Deduction","C2334200","","35.40","20020.67"
"512","TCCL1002 - KUMAR CABLE NETWORK ( TNTDNTCCL1002 ) ","2023-09-21 01:32:26","DDL1698260035","Deduction","C2334200","","84.61","19936.06"
"513","TCCL1002 - KUMAR CABLE NETWORK ( TNTDNTCCL1002 ) ","2023-09-21 01:32:26","DDL1698260060","Deduction","C1468093","","35.40","19900.66"
"514","TCCL1002 - KUMAR CABLE NETWORK ( TNTDNTCCL1002 ) ","2023-09-21 01:32:26","DDL1698260065","Deduction","C1468093","","84.61","19816.05"
"515","TCCL1002 - KUMAR CABLE NETWORK ( TNTDNTCCL1002 ) ","2023-09-21 01:32:26","DDL1698260090","Deduction","C1693302","","35.40","19780.65"
"516","TCCL1002 - KUMAR CABLE NETWORK ( TNTDNTCCL1002 ) ","2023-09-21 01:32:26","DDL1698260095","Deduction","C1693302","","84.61","19696.04"
"517","TCCL1002 - KUMAR CABLE NETWORK ( TNTDNTCCL1002 ) ","2023-09-21 01:32:26","DDL1698260105","Deduction","C5130647","","35.40","19660.64"
"518","TCCL1002 - KUMAR CABLE NETWORK ( TNTDNTCCL1002 ) ","2023-09-21 01:32:26","DDL1698260110","Deduction","C5130647","","84.61","19576.03"
"519","TCCL1002 - KUMAR CABLE NETWORK ( TNTDNTCCL1002 ) ","2023-09-21 01:32:26","DDL1698260115","Deduction","C5130647","","20.18","19555.85"
"520","TCCL1002 - KUMAR CABLE NETWORK ( TNTDNTCCL1002 ) ","2023-09-21 01:32:26","DDL1698260120","Deduction","C5130647","","20.18","19535.67"
"521","TCCL1002 - KUMAR CABLE NETWORK ( TNTDNTCCL1002 ) ","2023-09-21 01:32:26","DDL1698260125","Deduction","C5130647","","20.18","19515.49"
"522","TCCL1002 - KUMAR CABLE NETWORK ( TNTDNTCCL1002 ) ","2023-09-21 01:32:26","DDL1698260150","Deduction","C1495996","","35.40","19480.09"
"523","TCCL1002 - KUMAR CABLE NETWORK ( TNTDNTCCL1002 ) ","2023-09-21 01:32:26","DDL1698260155","Deduction","C1495996","","84.61","19395.48"
"524","TCCL1002 - KUMAR CABLE NETWORK ( TNTDNTCCL1002 ) ","2023-09-21 01:32:26","DDL1698260180","Deduction","C1448881","","35.40","19360.08"
"525","TCCL1002 - KUMAR CABLE NETWORK ( TNTDNTCCL1002 ) ","2023-09-21 01:32:26","DDL1698260185","Deduction","C1448881","","84.61","19275.47"
"526","TCCL1002 - KUMAR CABLE NETWORK ( TNTDNTCCL1002 ) ","2023-09-21 01:32:26","DDL1698260205","Deduction","C4993282","","35.40","19240.07"
"527","TCCL1002 - KUMAR CABLE NETWORK ( TNTDNTCCL1002 ) ","2023-09-21 01:32:26","DDL1698260210","Deduction","C4993282","","84.61","19155.46"
"528","TCCL1002 - KUMAR CABLE NETWORK ( TNTDNTCCL1002 ) ","2023-09-21 01:32:27","DDL1698260230","Deduction","C1468095","","35.40","19120.06"
"529","TCCL1002 - KUMAR CABLE NETWORK ( TNTDNTCCL1002 ) ","2023-09-21 01:32:27","DDL1698260235","Deduction","C1468095","","84.61","19035.45"
"530","TCCL1002 - KUMAR CABLE NETWORK ( TNTDNTCCL1002 ) ","2023-09-21 01:32:27","DDL1698260250","Deduction","C4183113","","35.40","19000.05"
"531","TCCL1002 - KUMAR CABLE NETWORK ( TNTDNTCCL1002 ) ","2023-09-21 01:32:27","DDL1698260255","Deduction","C4183113","","84.61","18915.44"
"532","TCCL1002 - KUMAR CABLE NETWORK ( TNTDNTCCL1002 ) ","2023-09-21 01:32:27","DDL1698260275","Deduction","C1291191","","35.40","18880.04"
"533","TCCL1002 - KUMAR CABLE NETWORK ( TNTDNTCCL1002 ) ","2023-09-21 01:32:27","DDL1698260280","Deduction","C1291191","","84.61","18795.43"
"534","TCCL1002 - KUMAR CABLE NETWORK ( TNTDNTCCL1002 ) ","2023-09-21 01:32:27","DDL1698260285","Deduction","C1427146","","35.40","18760.03"
"535","TCCL1002 - KUMAR CABLE NETWORK ( TNTDNTCCL1002 ) ","2023-09-21 01:32:27","DDL1698260290","Deduction","C1427146","","84.61","18675.42"
"536","TCCL1002 - KUMAR CABLE NETWORK ( TNTDNTCCL1002 ) ","2023-09-21 01:32:27","DDL1698260310","Deduction","C5056626","","35.40","18640.02"
"537","TCCL1002 - KUMAR CABLE NETWORK ( TNTDNTCCL1002 ) ","2023-09-21 01:32:27","DDL1698260315","Deduction","C5056626","","84.61","18555.41"
"538","TCCL1002 - KUMAR CABLE NETWORK ( TNTDNTCCL1002 ) ","2023-09-21 01:32:27","DDL1698260335","Deduction","C3737584","","35.40","18520.01"
"539","TCCL1002 - KUMAR CABLE NETWORK ( TNTDNTCCL1002 ) ","2023-09-21 01:32:27","DDL1698260340","Deduction","C3737584","","84.61","18435.4"
"540","TCCL1002 - KUMAR CABLE NETWORK ( TNTDNTCCL1002 ) ","2023-09-21 01:32:27","DDL1698260360","Deduction","C1468101","","35.40","18400"
"541","TCCL1002 - KUMAR CABLE NETWORK ( TNTDNTCCL1002 ) ","2023-09-21 01:32:27","DDL1698260365","Deduction","C1468101","","84.61","18315.39"
"542","TCCL1002 - KUMAR CABLE NETWORK ( TNTDNTCCL1002 ) ","2023-09-21 01:32:27","DDL1698260385","Deduction","C2149806","","35.40","18279.99"
"543","TCCL1002 - KUMAR CABLE NETWORK ( TNTDNTCCL1002 ) ","2023-09-21 01:32:27","DDL1698260390","Deduction","C2149806","","84.61","18195.38"
"544","TCCL1002 - KUMAR CABLE NETWORK ( TNTDNTCCL1002 ) ","2023-09-21 01:32:27","DDL1698260400","Deduction","C1427055","","35.40","18159.98"
"545","TCCL1002 - KUMAR CABLE NETWORK ( TNTDNTCCL1002 ) ","2023-09-21 01:32:27","DDL1698260405","Deduction","C1427055","","84.61","18075.37"
"546","TCCL1002 - KUMAR CABLE NETWORK ( TNTDNTCCL1002 ) ","2023-09-21 01:32:27","DDL1698260430","Deduction","C12213465","","35.40","18039.97"
"547","TCCL1002 - KUMAR CABLE NETWORK ( TNTDNTCCL1002 ) ","2023-09-21 01:32:27","DDL1698260435","Deduction","C12213465","","84.61","17955.36"
"548","TCCL1002 - KUMAR CABLE NETWORK ( TNTDNTCCL1002 ) ","2023-09-21 01:32:27","DDL1698260450","Deduction","C1427641","","35.40","17919.96"
"549","TCCL1002 - KUMAR CABLE NETWORK ( TNTDNTCCL1002 ) ","2023-09-21 01:32:27","DDL1698260455","Deduction","C1427641","","84.61","17835.35"
"550","TCCL1002 - KUMAR CABLE NETWORK ( TNTDNTCCL1002 ) ","2023-09-21 01:32:27","DDL1698260480","Deduction","C1244143","","35.40","17799.95"
"551","TCCL1002 - KUMAR CABLE NETWORK ( TNTDNTCCL1002 ) ","2023-09-21 01:32:27","DDL1698260485","Deduction","C1244143","","84.61","17715.34"
"552","TCCL1002 - KUMAR CABLE NETWORK ( TNTDNTCCL1002 ) ","2023-09-21 01:32:28","DDL1698260490","Deduction","C1432102","","35.40","17679.94"
"553","TCCL1002 - KUMAR CABLE NETWORK ( TNTDNTCCL1002 ) ","2023-09-21 01:32:28","DDL1698260495","Deduction","C1432102","","84.61","17595.33"
"554","TCCL1002 - KUMAR CABLE NETWORK ( TNTDNTCCL1002 ) ","2023-09-21 01:32:28","DDL1698260535","Deduction","C4300560","","35.40","17559.93"
"555","TCCL1002 - KUMAR CABLE NETWORK ( TNTDNTCCL1002 ) ","2023-09-21 01:32:28","DDL1698260540","Deduction","C4300560","","84.61","17475.32"
"556","TCCL1002 - KUMAR CABLE NETWORK ( TNTDNTCCL1002 ) ","2023-09-21 01:32:28","DDL1698260560","Deduction","C1291189","","33.04","17442.28"
"557","TCCL1002 - KUMAR CABLE NETWORK ( TNTDNTCCL1002 ) ","2023-09-21 01:32:28","DDL1698260565","Deduction","C1291189","","78.97","17363.31"
"558","TCCL1002 - KUMAR CABLE NETWORK ( TNTDNTCCL1002 ) ","2023-09-21 01:32:28","DDL1698260575","Deduction","C3875743","","35.40","17327.91"
"559","TCCL1002 - KUMAR CABLE NETWORK ( TNTDNTCCL1002 ) ","2023-09-21 01:32:28","DDL1698260580","Deduction","C3875743","","84.61","17243.3"
"560","TCCL1002 - KUMAR CABLE NETWORK ( TNTDNTCCL1002 ) ","2023-09-21 01:32:28","DDL1698260605","Deduction","C1459352","","35.40","17207.9"
"561","TCCL1002 - KUMAR CABLE NETWORK ( TNTDNTCCL1002 ) ","2023-09-21 01:32:28","DDL1698260610","Deduction","C1459352","","84.61","17123.29"
"562","TCCL1002 - KUMAR CABLE NETWORK ( TNTDNTCCL1002 ) ","2023-09-21 01:32:28","DDL1698260620","Deduction","C4300548","","35.40","17087.89"
"563","TCCL1002 - KUMAR CABLE NETWORK ( TNTDNTCCL1002 ) ","2023-09-21 01:32:28","DDL1698260625","Deduction","C4300548","","84.61","17003.28"
"564","TCCL1002 - KUMAR CABLE NETWORK ( TNTDNTCCL1002 ) ","2023-09-21 01:32:28","DDL1698260650","Deduction","C0769247","","35.40","16967.88"
"565","TCCL1002 - KUMAR CABLE NETWORK ( TNTDNTCCL1002 ) ","2023-09-21 01:32:28","DDL1698260655","Deduction","C0769247","","84.61","16883.27"
"566","TCCL1002 - KUMAR CABLE NETWORK ( TNTDNTCCL1002 ) ","2023-09-21 01:32:28","DDL1698260680","Deduction","C0756488","","35.40","16847.87"
"567","TCCL1002 - KUMAR CABLE NETWORK ( TNTDNTCCL1002 ) ","2023-09-21 01:32:28","DDL1698260685","Deduction","C0756488","","84.61","16763.26"
"568","TCCL1002 - KUMAR CABLE NETWORK ( TNTDNTCCL1002 ) ","2023-09-21 01:32:28","DDL1698260695","Deduction","C3342594","","35.40","16727.86"
"569","TCCL1002 - KUMAR CABLE NETWORK ( TNTDNTCCL1002 ) ","2023-09-21 01:32:28","DDL1698260700","Deduction","C3342594","","84.61","16643.25"
"570","TCCL1002 - KUMAR CABLE NETWORK ( TNTDNTCCL1002 ) ","2023-09-21 01:32:28","DDL1698260725","Deduction","C1437360","","35.40","16607.85"
"571","TCCL1002 - KUMAR CABLE NETWORK ( TNTDNTCCL1002 ) ","2023-09-21 01:32:28","DDL1698260730","Deduction","C1437360","","84.61","16523.24"
"572","TCCL1002 - KUMAR CABLE NETWORK ( TNTDNTCCL1002 ) ","2023-09-21 01:32:28","DDL1698260775","Deduction","C2334438","","35.40","16487.84"
"573","TCCL1002 - KUMAR CABLE NETWORK ( TNTDNTCCL1002 ) ","2023-09-21 01:32:28","DDL1698260780","Deduction","C2334438","","84.61","16403.23"
"574","TCCL1002 - KUMAR CABLE NETWORK ( TNTDNTCCL1002 ) ","2023-09-21 01:32:28","DDL1698260795","Deduction","C0769358","","35.40","16367.83"
"575","TCCL1002 - KUMAR CABLE NETWORK ( TNTDNTCCL1002 ) ","2023-09-21 01:32:28","DDL1698260800","Deduction","C0769358","","84.61","16283.22"
"576","TCCL1002 - KUMAR CABLE NETWORK ( TNTDNTCCL1002 ) ","2023-09-21 01:32:28","DDL1698260810","Deduction","C7832592","","35.40","16247.82"
"577","TCCL1002 - KUMAR CABLE NETWORK ( TNTDNTCCL1002 ) ","2023-09-21 01:32:28","DDL1698260815","Deduction","C7832592","","84.61","16163.21"
"578","TCCL1002 - KUMAR CABLE NETWORK ( TNTDNTCCL1002 ) ","2023-09-21 01:32:29","DDL1698260830","Deduction","C4184972","","35.40","16127.81"
"579","TCCL1002 - KUMAR CABLE NETWORK ( TNTDNTCCL1002 ) ","2023-09-21 01:32:29","DDL1698260835","Deduction","C4184972","","84.61","16043.2"
"580","TCCL1002 - KUMAR CABLE NETWORK ( TNTDNTCCL1002 ) ","2023-09-21 01:32:29","DDL1698260865","Deduction","C6144382","","35.40","16007.8"
"581","TCCL1002 - KUMAR CABLE NETWORK ( TNTDNTCCL1002 ) ","2023-09-21 01:32:29","DDL1698260870","Deduction","C6144382","","84.61","15923.19"
"582","TCCL1002 - KUMAR CABLE NETWORK ( TNTDNTCCL1002 ) ","2023-09-21 01:32:29","DDL1698260875","Deduction","C1693301","","35.40","15887.79"
"583","TCCL1002 - KUMAR CABLE NETWORK ( TNTDNTCCL1002 ) ","2023-09-21 01:32:29","DDL1698260880","Deduction","C1693301","","124.60","15763.19"
"584","TCCL1002 - KUMAR CABLE NETWORK ( TNTDNTCCL1002 ) ","2023-09-21 01:32:29","DDL1698260895","Deduction","C2120530","","35.40","15727.79"
"585","TCCL1002 - KUMAR CABLE NETWORK ( TNTDNTCCL1002 ) ","2023-09-21 01:32:29","DDL1698260900","Deduction","C2120530","","84.61","15643.18"
"586","TCCL1002 - KUMAR CABLE NETWORK ( TNTDNTCCL1002 ) ","2023-09-21 01:32:29","DDL1698260915","Deduction","C1427006","","35.40","15607.78"
"587","TCCL1002 - KUMAR CABLE NETWORK ( TNTDNTCCL1002 ) ","2023-09-21 01:32:29","DDL1698260920","Deduction","C1427006","","84.61","15523.17"
"588","TCCL1002 - KUMAR CABLE NETWORK ( TNTDNTCCL1002 ) ","2023-09-21 01:32:29","DDL1698260950","Deduction","C5076832","","35.40","15487.77"
"589","TCCL1002 - KUMAR CABLE NETWORK ( TNTDNTCCL1002 ) ","2023-09-21 01:32:29","DDL1698260955","Deduction","C5076832","","84.61","15403.16"
"590","TCCL1002 - KUMAR CABLE NETWORK ( TNTDNTCCL1002 ) ","2023-09-21 01:32:29","DDL1698260965","Deduction","C1554617","","35.40","15367.76"
"591","TCCL1002 - KUMAR CABLE NETWORK ( TNTDNTCCL1002 ) ","2023-09-21 01:32:29","DDL1698260970","Deduction","C1554617","","84.61","15283.15"
"592","TCCL1002 - KUMAR CABLE NETWORK ( TNTDNTCCL1002 ) ","2023-09-21 01:32:29","DDL1698260995","Deduction","C1554069","","35.40","15247.75"
"593","TCCL1002 - KUMAR CABLE NETWORK ( TNTDNTCCL1002 ) ","2023-09-21 01:32:29","DDL1698261000","Deduction","C1554069","","84.61","15163.14"
"594","TCCL1002 - KUMAR CABLE NETWORK ( TNTDNTCCL1002 ) ","2023-09-21 01:32:29","DDL1698261030","Deduction","C1010021","","35.40","15127.74"
"595","TCCL1002 - KUMAR CABLE NETWORK ( TNTDNTCCL1002 ) ","2023-09-21 01:32:29","DDL1698261035","Deduction","C1010021","","84.61","15043.13"
"596","TCCL1002 - KUMAR CABLE NETWORK ( TNTDNTCCL1002 ) ","2023-09-21 01:32:29","DDL1698261050","Deduction","C11942814","","35.40","15007.73"
"597","TCCL1002 - KUMAR CABLE NETWORK ( TNTDNTCCL1002 ) ","2023-09-21 01:32:29","DDL1698261055","Deduction","C11942814","","84.61","14923.12"
"598","TCCL1002 - KUMAR CABLE NETWORK ( TNTDNTCCL1002 ) ","2023-09-21 01:32:29","DDL1698261080","Deduction","C5146791","","35.40","14887.72"
"599","TCCL1002 - KUMAR CABLE NETWORK ( TNTDNTCCL1002 ) ","2023-09-21 01:32:29","DDL1698261085","Deduction","C5146791","","84.61","14803.11"
"600","TCCL1002 - KUMAR CABLE NETWORK ( TNTDNTCCL1002 ) ","2023-09-21 01:32:29","DDL1698261100","Deduction","C8719391","","35.40","14767.71"
"601","TCCL1002 - KUMAR CABLE NETWORK ( TNTDNTCCL1002 ) ","2023-09-21 01:32:29","DDL1698261105","Deduction","C8719391","","84.61","14683.1"
"602","TCCL1002 - KUMAR CABLE NETWORK ( TNTDNTCCL1002 ) ","2023-09-21 01:32:29","DDL1698261115","Deduction","C1676819","","35.40","14647.7"
"603","TCCL1002 - KUMAR CABLE NETWORK ( TNTDNTCCL1002 ) ","2023-09-21 01:32:29","DDL1698261120","Deduction","C1676819","","84.61","14563.09"
"604","TCCL1002 - KUMAR CABLE NETWORK ( TNTDNTCCL1002 ) ","2023-09-21 01:32:29","DDL1698261145","Deduction","C1291192","","35.40","14527.69"
"605","TCCL1002 - KUMAR CABLE NETWORK ( TNTDNTCCL1002 ) ","2023-09-21 01:32:29","DDL1698261150","Deduction","C1291192","","84.61","14443.08"
"606","TCCL1002 - KUMAR CABLE NETWORK ( TNTDNTCCL1002 ) ","2023-09-21 01:32:30","DDL1698261160","Deduction","C4300557","","35.40","14407.68"
"607","TCCL1002 - KUMAR CABLE NETWORK ( TNTDNTCCL1002 ) ","2023-09-21 01:32:30","DDL1698261165","Deduction","C4300557","","84.61","14323.07"
"608","TCCL1002 - KUMAR CABLE NETWORK ( TNTDNTCCL1002 ) ","2023-09-21 01:32:30","DDL1698261175","Deduction","C6725457","","21.24","14301.83"
"609","TCCL1002 - KUMAR CABLE NETWORK ( TNTDNTCCL1002 ) ","2023-09-21 01:32:30","DDL1698261180","Deduction","C6725457","","50.76","14251.07"
"610","TCCL1002 - KUMAR CABLE NETWORK ( TNTDNTCCL1002 ) ","2023-09-21 01:32:30","DDL1698261200","Deduction","C1468096","","35.40","14215.67"
"611","TCCL1002 - KUMAR CABLE NETWORK ( TNTDNTCCL1002 ) ","2023-09-21 01:32:30","DDL1698261205","Deduction","C1468096","","84.61","14131.06"
"612","TCCL1002 - KUMAR CABLE NETWORK ( TNTDNTCCL1002 ) ","2023-09-21 01:32:30","DDL1698261225","Deduction","C3341959","","35.40","14095.66"
"613","TCCL1002 - KUMAR CABLE NETWORK ( TNTDNTCCL1002 ) ","2023-09-21 01:32:30","DDL1698261230","Deduction","C3341959","","84.61","14011.05"
"614","TCCL1002 - KUMAR CABLE NETWORK ( TNTDNTCCL1002 ) ","2023-09-21 01:32:30","DDL1698261245","Deduction","C3066959","","35.40","13975.65"
"615","TCCL1002 - KUMAR CABLE NETWORK ( TNTDNTCCL1002 ) ","2023-09-21 01:32:30","DDL1698261250","Deduction","C3066959","","124.60","13851.05"
"616","TCCL1002 - KUMAR CABLE NETWORK ( TNTDNTCCL1002 ) ","2023-09-21 01:32:30","DDL1698261265","Deduction","C1448873","","35.40","13815.65"
"617","TCCL1002 - KUMAR CABLE NETWORK ( TNTDNTCCL1002 ) ","2023-09-21 01:32:30","DDL1698261270","Deduction","C1448873","","84.61","13731.04"
"618","TCCL1002 - KUMAR CABLE NETWORK ( TNTDNTCCL1002 ) ","2023-09-21 01:32:30","DDL1698261280","Deduction","C2112697","","35.40","13695.64"
"619","TCCL1002 - KUMAR CABLE NETWORK ( TNTDNTCCL1002 ) ","2023-09-21 01:32:30","DDL1698261285","Deduction","C2112697","","84.61","13611.03"
"620","TCCL1002 - KUMAR CABLE NETWORK ( TNTDNTCCL1002 ) ","2023-09-21 01:32:30","DDL1698261315","Deduction","C8151612","","35.40","13575.63"
"621","TCCL1002 - KUMAR CABLE NETWORK ( TNTDNTCCL1002 ) ","2023-09-21 01:32:30","DDL1698261320","Deduction","C8151612","","84.61","13491.02"
"622","TCCL1002 - KUMAR CABLE NETWORK ( TNTDNTCCL1002 ) ","2023-09-21 01:32:30","DDL1698261330","Deduction","C2361951","","35.40","13455.62"
"623","TCCL1002 - KUMAR CABLE NETWORK ( TNTDNTCCL1002 ) ","2023-09-21 01:32:30","DDL1698261335","Deduction","C2361951","","84.61","13371.01"
"624","TCCL1002 - KUMAR CABLE NETWORK ( TNTDNTCCL1002 ) ","2023-09-21 01:32:30","DDL1698261350","Deduction","C1554616","","35.40","13335.61"
"625","TCCL1002 - KUMAR CABLE NETWORK ( TNTDNTCCL1002 ) ","2023-09-21 01:32:30","DDL1698261355","Deduction","C1554616","","84.61","13251"
"626","TCCL1002 - KUMAR CABLE NETWORK ( TNTDNTCCL1002 ) ","2023-09-21 01:32:30","DDL1698261365","Deduction","C1449005","","35.40","13215.6"
"627","TCCL1002 - KUMAR CABLE NETWORK ( TNTDNTCCL1002 ) ","2023-09-21 01:32:30","DDL1698261370","Deduction","C1449005","","84.61","13130.99"
"628","TCCL1002 - KUMAR CABLE NETWORK ( TNTDNTCCL1002 ) ","2023-09-21 01:32:30","DDL1698261390","Deduction","C7419138","","35.40","13095.59"
"629","TCCL1002 - KUMAR CABLE NETWORK ( TNTDNTCCL1002 ) ","2023-09-21 01:32:30","DDL1698261395","Deduction","C7419138","","84.61","13010.98"
"630","TCCL1002 - KUMAR CABLE NETWORK ( TNTDNTCCL1002 ) ","2023-09-21 01:32:30","DDL1698261400","Deduction","C9246684","","35.40","12975.58"
"631","TCCL1002 - KUMAR CABLE NETWORK ( TNTDNTCCL1002 ) ","2023-09-21 01:32:30","DDL1698261415","Deduction","C9246684","","84.61","12890.97"
"632","TCCL1002 - KUMAR CABLE NETWORK ( TNTDNTCCL1002 ) ","2023-09-21 01:32:30","DDL1698261420","Deduction","C2051430","","35.40","12855.57"
"633","TCCL1002 - KUMAR CABLE NETWORK ( TNTDNTCCL1002 ) ","2023-09-21 01:32:30","DDL1698261425","Deduction","C2051430","","84.61","12770.96"
"634","TCCL1002 - KUMAR CABLE NETWORK ( TNTDNTCCL1002 ) ","2023-09-21 01:32:31","DDL1698261445","Deduction","C1495997","","35.40","12735.56"
"635","TCCL1002 - KUMAR CABLE NETWORK ( TNTDNTCCL1002 ) ","2023-09-21 01:32:31","DDL1698261450","Deduction","C1495997","","84.61","12650.95"
"636","TCCL1002 - KUMAR CABLE NETWORK ( TNTDNTCCL1002 ) ","2023-09-21 01:32:31","DDL1698261480","Deduction","C0912432","","35.40","12615.55"
"637","TCCL1002 - KUMAR CABLE NETWORK ( TNTDNTCCL1002 ) ","2023-09-21 01:32:31","DDL1698261485","Deduction","C0912432","","84.61","12530.94"
"638","TCCL1002 - KUMAR CABLE NETWORK ( TNTDNTCCL1002 ) ","2023-09-21 01:32:31","DDL1698261505","Deduction","C12335179","","35.40","12495.54"
"639","TCCL1002 - KUMAR CABLE NETWORK ( TNTDNTCCL1002 ) ","2023-09-21 01:32:31","DDL1698261510","Deduction","C12335179","","84.61","12410.93"
"640","TCCL1002 - KUMAR CABLE NETWORK ( TNTDNTCCL1002 ) ","2023-09-21 01:32:31","DDL1698261515","Deduction","C3913039","","35.40","12375.53"
"641","TCCL1002 - KUMAR CABLE NETWORK ( TNTDNTCCL1002 ) ","2023-09-21 01:32:31","DDL1698261530","Deduction","C3913039","","84.61","12290.92"
"642","TCCL1002 - KUMAR CABLE NETWORK ( TNTDNTCCL1002 ) ","2023-09-21 01:32:31","DDL1698261555","Deduction","C1427096","","35.40","12255.52"
"643","TCCL1002 - KUMAR CABLE NETWORK ( TNTDNTCCL1002 ) ","2023-09-21 01:32:31","DDL1698261565","Deduction","C1427096","","84.61","12170.91"
"644","TCCL1002 - KUMAR CABLE NETWORK ( TNTDNTCCL1002 ) ","2023-09-21 01:32:31","DDL1698261590","Deduction","C1291197","","35.40","12135.51"
"645","TCCL1002 - KUMAR CABLE NETWORK ( TNTDNTCCL1002 ) ","2023-09-21 01:32:31","DDL1698261595","Deduction","C1291197","","84.61","12050.9"
"646","TCCL1002 - KUMAR CABLE NETWORK ( TNTDNTCCL1002 ) ","2023-09-21 01:32:31","DDL1698261615","Deduction","C1101626","","35.40","12015.5"
"647","TCCL1002 - KUMAR CABLE NETWORK ( TNTDNTCCL1002 ) ","2023-09-21 01:32:31","DDL1698261620","Deduction","C1101626","","84.61","11930.89"
"648","TCCL1002 - KUMAR CABLE NETWORK ( TNTDNTCCL1002 ) ","2023-09-21 01:32:31","DDL1698261640","Deduction","C1426504","","35.40","11895.49"
"649","TCCL1002 - KUMAR CABLE NETWORK ( TNTDNTCCL1002 ) ","2023-09-21 01:32:31","DDL1698261645","Deduction","C1426504","","84.61","11810.88"
"650","TCCL1002 - KUMAR CABLE NETWORK ( TNTDNTCCL1002 ) ","2023-09-21 01:32:31","DDL1698261665","Deduction","C0798159","","35.40","11775.48"
"651","TCCL1002 - KUMAR CABLE NETWORK ( TNTDNTCCL1002 ) ","2023-09-21 01:32:31","DDL1698261670","Deduction","C0798159","","84.61","11690.87"
"652","TCCL1002 - KUMAR CABLE NETWORK ( TNTDNTCCL1002 ) ","2023-09-21 01:32:31","DDL1698261690","Deduction","C2558743","","35.40","11655.47"
"653","TCCL1002 - KUMAR CABLE NETWORK ( TNTDNTCCL1002 ) ","2023-09-21 01:32:31","DDL1698261695","Deduction","C2558743","","84.61","11570.86"
"654","TCCL1002 - KUMAR CABLE NETWORK ( TNTDNTCCL1002 ) ","2023-09-21 01:32:31","DDL1698261715","Deduction","C5143534","","35.40","11535.46"
"655","TCCL1002 - KUMAR CABLE NETWORK ( TNTDNTCCL1002 ) ","2023-09-21 01:32:31","DDL1698261720","Deduction","C5143534","","84.61","11450.85"
"656","TCCL1002 - KUMAR CABLE NETWORK ( TNTDNTCCL1002 ) ","2023-09-21 01:32:31","DDL1698261730","Deduction","C1554067","","35.40","11415.45"
"657","TCCL1002 - KUMAR CABLE NETWORK ( TNTDNTCCL1002 ) ","2023-09-21 01:32:31","DDL1698261735","Deduction","C1554067","","84.61","11330.84"
"658","TCCL1002 - KUMAR CABLE NETWORK ( TNTDNTCCL1002 ) ","2023-09-21 01:32:31","DDL1698261750","Deduction","C0912367","","35.40","11295.44"
"659","TCCL1002 - KUMAR CABLE NETWORK ( TNTDNTCCL1002 ) ","2023-09-21 01:32:31","DDL1698261755","Deduction","C0912367","","84.61","11210.83"
"660","TCCL1002 - KUMAR CABLE NETWORK ( TNTDNTCCL1002 ) ","2023-09-21 01:32:31","DDL1698261785","Deduction","C4810648","","35.40","11175.43"
"661","TCCL1002 - KUMAR CABLE NETWORK ( TNTDNTCCL1002 ) ","2023-09-21 01:32:31","DDL1698261790","Deduction","C4810648","","84.61","11090.82"
"662","TCCL1002 - KUMAR CABLE NETWORK ( TNTDNTCCL1002 ) ","2023-09-21 01:32:31","DDL1698261795","Deduction","C10956878","","35.40","11055.42"
"663","TCCL1002 - KUMAR CABLE NETWORK ( TNTDNTCCL1002 ) ","2023-09-21 01:32:31","DDL1698261800","Deduction","C10956878","","84.61","10970.81"
"664","TCCL1002 - KUMAR CABLE NETWORK ( TNTDNTCCL1002 ) ","2023-09-21 01:32:32","DDL1698261815","Deduction","C1554611","","35.40","10935.41"
"665","TCCL1002 - KUMAR CABLE NETWORK ( TNTDNTCCL1002 ) ","2023-09-21 01:32:32","DDL1698261820","Deduction","C1554611","","84.61","10850.8"
"666","TCCL1002 - KUMAR CABLE NETWORK ( TNTDNTCCL1002 ) ","2023-09-21 01:32:32","DDL1698261850","Deduction","C1432096","","35.40","10815.4"
"667","TCCL1002 - KUMAR CABLE NETWORK ( TNTDNTCCL1002 ) ","2023-09-21 01:32:32","DDL1698261860","Deduction","C1432096","","84.61","10730.79"
"668","TCCL1002 - KUMAR CABLE NETWORK ( TNTDNTCCL1002 ) ","2023-09-21 01:32:32","DDL1698261875","Deduction","C1437289","","35.40","10695.39"
"669","TCCL1002 - KUMAR CABLE NETWORK ( TNTDNTCCL1002 ) ","2023-09-21 01:32:32","DDL1698261880","Deduction","C1437289","","84.61","10610.78"
"670","TCCL1002 - KUMAR CABLE NETWORK ( TNTDNTCCL1002 ) ","2023-09-21 01:32:32","DDL1698261910","Deduction","C0777090","","35.40","10575.38"
"671","TCCL1002 - KUMAR CABLE NETWORK ( TNTDNTCCL1002 ) ","2023-09-21 01:32:32","DDL1698261915","Deduction","C0777090","","84.61","10490.77"
"672","TCCL1002 - KUMAR CABLE NETWORK ( TNTDNTCCL1002 ) ","2023-09-21 01:32:32","DDL1698261930","Deduction","C1437320","","35.40","10455.37"
"673","TCCL1002 - KUMAR CABLE NETWORK ( TNTDNTCCL1002 ) ","2023-09-21 01:32:32","DDL1698261935","Deduction","C1437320","","84.61","10370.76"
"674","TCCL1002 - KUMAR CABLE NETWORK ( TNTDNTCCL1002 ) ","2023-09-21 01:32:32","DDL1698261955","Deduction","C1425806","","35.40","10335.36"
"675","TCCL1002 - KUMAR CABLE NETWORK ( TNTDNTCCL1002 ) ","2023-09-21 01:32:32","DDL1698261960","Deduction","C1425806","","84.61","10250.75"
"676","TCCL1002 - KUMAR CABLE NETWORK ( TNTDNTCCL1002 ) ","2023-09-21 01:32:32","DDL1698261970","Deduction","C0839779","","35.40","10215.35"
"677","TCCL1002 - KUMAR CABLE NETWORK ( TNTDNTCCL1002 ) ","2023-09-21 01:32:32","DDL1698261975","Deduction","C0839779","","84.61","10130.74"
"678","TCCL1002 - KUMAR CABLE NETWORK ( TNTDNTCCL1002 ) ","2023-09-21 01:32:32","DDL1698261995","Deduction","C1449004","","35.40","10095.34"
"679","TCCL1002 - KUMAR CABLE NETWORK ( TNTDNTCCL1002 ) ","2023-09-21 01:32:32","DDL1698262000","Deduction","C1449004","","84.61","10010.73"
"680","TCCL1002 - KUMAR CABLE NETWORK ( TNTDNTCCL1002 ) ","2023-09-21 01:32:32","DDL1698262015","Deduction","C1267818","","35.40","9975.33"
"681","TCCL1002 - KUMAR CABLE NETWORK ( TNTDNTCCL1002 ) ","2023-09-21 01:32:32","DDL1698262020","Deduction","C1267818","","84.61","9890.72"
"682","TCCL1002 - KUMAR CABLE NETWORK ( TNTDNTCCL1002 ) ","2023-09-21 01:32:32","DDL1698262030","Deduction","C0797263","","35.40","9855.32"
"683","TCCL1002 - KUMAR CABLE NETWORK ( TNTDNTCCL1002 ) ","2023-09-21 01:32:32","DDL1698262035","Deduction","C0797263","","84.61","9770.71"
"684","TCCL1002 - KUMAR CABLE NETWORK ( TNTDNTCCL1002 ) ","2023-09-21 01:32:32","DDL1698262060","Deduction","C1010622","","35.40","9735.31"
"685","TCCL1002 - KUMAR CABLE NETWORK ( TNTDNTCCL1002 ) ","2023-09-21 01:32:32","DDL1698262065","Deduction","C1010622","","84.61","9650.7"
"686","TCCL1002 - KUMAR CABLE NETWORK ( TNTDNTCCL1002 ) ","2023-09-21 01:32:32","DDL1698262100","Deduction","C5271559","","35.40","9615.3"
"687","TCCL1002 - KUMAR CABLE NETWORK ( TNTDNTCCL1002 ) ","2023-09-21 01:32:32","DDL1698262105","Deduction","C5271559","","84.61","9530.69"
"688","TCCL1002 - KUMAR CABLE NETWORK ( TNTDNTCCL1002 ) ","2023-09-21 01:32:33","DDL1698262135","Deduction","C0839942","","35.40","9495.29"
"689","TCCL1002 - KUMAR CABLE NETWORK ( TNTDNTCCL1002 ) ","2023-09-21 01:32:33","DDL1698262140","Deduction","C0839942","","84.61","9410.68"
"690","TCCL1002 - KUMAR CABLE NETWORK ( TNTDNTCCL1002 ) ","2023-09-21 01:32:33","DDL1698262165","Deduction","C2957470","","35.40","9375.28"
"691","TCCL1002 - KUMAR CABLE NETWORK ( TNTDNTCCL1002 ) ","2023-09-21 01:32:33","DDL1698262170","Deduction","C2957470","","84.61","9290.67"
"692","TCCL1002 - KUMAR CABLE NETWORK ( TNTDNTCCL1002 ) ","2023-09-21 01:32:33","DDL1698262190","Deduction","C6843192","","35.40","9255.27"
"693","TCCL1002 - KUMAR CABLE NETWORK ( TNTDNTCCL1002 ) ","2023-09-21 01:32:33","DDL1698262195","Deduction","C6843192","","84.61","9170.66"
"694","TCCL1002 - KUMAR CABLE NETWORK ( TNTDNTCCL1002 ) ","2023-09-21 01:32:33","DDL1698262220","Deduction","C2311055","","35.40","9135.26"
"695","TCCL1002 - KUMAR CABLE NETWORK ( TNTDNTCCL1002 ) ","2023-09-21 01:32:33","DDL1698262225","Deduction","C2311055","","47.78","9087.48"
"696","TCCL1002 - KUMAR CABLE NETWORK ( TNTDNTCCL1002 ) ","2023-09-21 01:32:33","DDL1698262235","Deduction","C1291195","","35.40","9052.08"
"697","TCCL1002 - KUMAR CABLE NETWORK ( TNTDNTCCL1002 ) ","2023-09-21 01:32:33","DDL1698262240","Deduction","C1291195","","84.61","8967.47"
"698","TCCL1002 - KUMAR CABLE NETWORK ( TNTDNTCCL1002 ) ","2023-09-21 01:32:33","DDL1698262265","Deduction","C0839950","","35.40","8932.07"
"699","TCCL1002 - KUMAR CABLE NETWORK ( TNTDNTCCL1002 ) ","2023-09-21 01:32:33","DDL1698262275","Deduction","C0839950","","84.61","8847.46"
"700","TCCL1002 - KUMAR CABLE NETWORK ( TNTDNTCCL1002 ) ","2023-09-21 01:32:33","DDL1698262285","Deduction","C2103869","","35.40","8812.06"
"701","TCCL1002 - KUMAR CABLE NETWORK ( TNTDNTCCL1002 ) ","2023-09-21 01:32:33","DDL1698262290","Deduction","C2103869","","84.61","8727.45"
"702","TCCL1002 - KUMAR CABLE NETWORK ( TNTDNTCCL1002 ) ","2023-09-21 01:32:33","DDL1698262310","Deduction","C10743576","","35.40","8692.05"
"703","TCCL1002 - KUMAR CABLE NETWORK ( TNTDNTCCL1002 ) ","2023-09-21 01:32:33","DDL1698262315","Deduction","C10743576","","84.61","8607.44"
"704","TCCL1002 - KUMAR CABLE NETWORK ( TNTDNTCCL1002 ) ","2023-09-21 01:32:33","DDL1698262325","Deduction","C2113643","","35.40","8572.04"
"705","TCCL1002 - KUMAR CABLE NETWORK ( TNTDNTCCL1002 ) ","2023-09-21 01:32:33","DDL1698262330","Deduction","C2113643","","84.61","8487.43"
"706","TCCL1002 - KUMAR CABLE NETWORK ( TNTDNTCCL1002 ) ","2023-09-21 01:32:33","DDL1698262335","Deduction","C7795023","","35.40","8452.03"
"707","TCCL1002 - KUMAR CABLE NETWORK ( TNTDNTCCL1002 ) ","2023-09-21 01:32:33","DDL1698262340","Deduction","C7795023","","84.61","8367.42"
"708","TCCL1002 - KUMAR CABLE NETWORK ( TNTDNTCCL1002 ) ","2023-09-21 01:32:33","DDL1698262355","Deduction","C1014398","","35.40","8332.02"
"709","TCCL1002 - KUMAR CABLE NETWORK ( TNTDNTCCL1002 ) ","2023-09-21 01:32:33","DDL1698262360","Deduction","C1014398","","164.79","8167.23"
"710","TCCL1002 - KUMAR CABLE NETWORK ( TNTDNTCCL1002 ) ","2023-09-21 01:32:33","DDL1698262365","Deduction","C1014398","","47.78","8119.45"
"711","TCCL1002 - KUMAR CABLE NETWORK ( TNTDNTCCL1002 ) ","2023-09-21 01:32:33","DDL1698262370","Deduction","C1014398","","6.38","8113.07"
"712","TCCL1002 - KUMAR CABLE NETWORK ( TNTDNTCCL1002 ) ","2023-09-21 01:32:33","DDL1698262375","Deduction","C1014398","","0.11","8112.96"
"713","TCCL1002 - KUMAR CABLE NETWORK ( TNTDNTCCL1002 ) ","2023-09-21 01:32:33","DDL1698262390","Deduction","C5092149","","35.40","8077.56"
"714","TCCL1002 - KUMAR CABLE NETWORK ( TNTDNTCCL1002 ) ","2023-09-21 01:32:33","DDL1698262395","Deduction","C5092149","","84.61","7992.95"
"715","TCCL1002 - KUMAR CABLE NETWORK ( TNTDNTCCL1002 ) ","2023-09-21 01:32:33","DDL1698262400","Deduction","C2551645","","35.40","7957.55"
"716","TCCL1002 - KUMAR CABLE NETWORK ( TNTDNTCCL1002 ) ","2023-09-21 01:32:33","DDL1698262405","Deduction","C2551645","","84.61","7872.94"
"717","TCCL1002 - KUMAR CABLE NETWORK ( TNTDNTCCL1002 ) ","2023-09-21 01:32:33","DDL1698262425","Deduction","C1425705","","35.40","7837.54"
"718","TCCL1002 - KUMAR CABLE NETWORK ( TNTDNTCCL1002 ) ","2023-09-21 01:32:33","DDL1698262430","Deduction","C1425705","","84.61","7752.93"
"719","TCCL1002 - KUMAR CABLE NETWORK ( TNTDNTCCL1002 ) ","2023-09-21 01:32:34","DDL1698262445","Deduction","C1468098","","35.40","7717.53"
"720","TCCL1002 - KUMAR CABLE NETWORK ( TNTDNTCCL1002 ) ","2023-09-21 01:32:34","DDL1698262450","Deduction","C1468098","","84.61","7632.92"
"721","TCCL1002 - KUMAR CABLE NETWORK ( TNTDNTCCL1002 ) ","2023-09-21 01:32:34","DDL1698262455","Deduction","C5994050","","35.40","7597.52"
"722","TCCL1002 - KUMAR CABLE NETWORK ( TNTDNTCCL1002 ) ","2023-09-21 01:32:34","DDL1698262460","Deduction","C5994050","","84.61","7512.91"
"723","TCCL1002 - KUMAR CABLE NETWORK ( TNTDNTCCL1002 ) ","2023-09-21 01:32:34","DDL1698262470","Deduction","C6063433","","35.40","7477.51"
"724","TCCL1002 - KUMAR CABLE NETWORK ( TNTDNTCCL1002 ) ","2023-09-21 01:32:34","DDL1698262475","Deduction","C6063433","","84.61","7392.9"
"725","TCCL1002 - KUMAR CABLE NETWORK ( TNTDNTCCL1002 ) ","2023-09-21 01:32:34","DDL1698262485","Deduction","C9927995","","35.40","7357.5"
"726","TCCL1002 - KUMAR CABLE NETWORK ( TNTDNTCCL1002 ) ","2023-09-21 01:32:34","DDL1698262490","Deduction","C9927995","","84.61","7272.89"
"727","TCCL1002 - KUMAR CABLE NETWORK ( TNTDNTCCL1002 ) ","2023-09-21 01:32:34","DDL1698262505","Deduction","C2566372","","35.40","7237.49"
"728","TCCL1002 - KUMAR CABLE NETWORK ( TNTDNTCCL1002 ) ","2023-09-21 01:32:34","DDL1698262510","Deduction","C2566372","","84.61","7152.88"
"729","TCCL1002 - KUMAR CABLE NETWORK ( TNTDNTCCL1002 ) ","2023-09-21 01:32:34","DDL1698262520","Deduction","C12157796","","35.40","7117.48"
"730","TCCL1002 - KUMAR CABLE NETWORK ( TNTDNTCCL1002 ) ","2023-09-21 01:32:34","DDL1698262525","Deduction","C12157796","","84.61","7032.87"
"731","TCCL1002 - KUMAR CABLE NETWORK ( TNTDNTCCL1002 ) ","2023-09-21 01:32:34","DDL1698262530","Deduction","C1495995","","35.40","6997.47"
"732","TCCL1002 - KUMAR CABLE NETWORK ( TNTDNTCCL1002 ) ","2023-09-21 01:32:34","DDL1698262535","Deduction","C1495995","","84.61","6912.86"
"733","TCCL1002 - KUMAR CABLE NETWORK ( TNTDNTCCL1002 ) ","2023-09-21 01:32:34","DDL1698262550","Deduction","C1430868","","35.40","6877.46"
"734","TCCL1002 - KUMAR CABLE NETWORK ( TNTDNTCCL1002 ) ","2023-09-21 01:32:34","DDL1698262555","Deduction","C1430868","","84.61","6792.85"
"735","TCCL1002 - KUMAR CABLE NETWORK ( TNTDNTCCL1002 ) ","2023-09-21 01:32:34","DDL1698262565","Deduction","C1554614","","35.40","6757.45"
"736","TCCL1002 - KUMAR CABLE NETWORK ( TNTDNTCCL1002 ) ","2023-09-21 01:32:34","DDL1698262570","Deduction","C1554614","","84.61","6672.84"
"737","TCCL1002 - KUMAR CABLE NETWORK ( TNTDNTCCL1002 ) ","2023-09-21 01:32:34","DDL1698262590","Deduction","C1237951","","35.40","6637.44"
"738","TCCL1002 - KUMAR CABLE NETWORK ( TNTDNTCCL1002 ) ","2023-09-21 01:32:34","DDL1698262595","Deduction","C1237951","","84.61","6552.83"
"739","TCCL1002 - KUMAR CABLE NETWORK ( TNTDNTCCL1002 ) ","2023-09-21 01:32:34","DDL1698262615","Deduction","C6115333","","35.40","6517.43"
"740","TCCL1002 - KUMAR CABLE NETWORK ( TNTDNTCCL1002 ) ","2023-09-21 01:32:34","DDL1698262620","Deduction","C6115333","","84.61","6432.82"
"741","TCCL1002 - KUMAR CABLE NETWORK ( TNTDNTCCL1002 ) ","2023-09-21 01:32:34","DDL1698262635","Deduction","C1238016","","35.40","6397.42"
"742","TCCL1002 - KUMAR CABLE NETWORK ( TNTDNTCCL1002 ) ","2023-09-21 01:32:34","DDL1698262640","Deduction","C1238016","","84.61","6312.81"
"743","TCCL1002 - KUMAR CABLE NETWORK ( TNTDNTCCL1002 ) ","2023-09-21 01:32:34","DDL1698262650","Deduction","C1432094","","35.40","6277.41"
"744","TCCL1002 - KUMAR CABLE NETWORK ( TNTDNTCCL1002 ) ","2023-09-21 01:32:34","DDL1698262655","Deduction","C1432094","","84.61","6192.8"
"745","TCCL1002 - KUMAR CABLE NETWORK ( TNTDNTCCL1002 ) ","2023-09-21 01:32:34","DDL1698262665","Deduction","C1448871","","35.40","6157.4"
"746","TCCL1002 - KUMAR CABLE NETWORK ( TNTDNTCCL1002 ) ","2023-09-21 01:32:34","DDL1698262670","Deduction","C1448871","","84.61","6072.79"
"747","TCCL1002 - KUMAR CABLE NETWORK ( TNTDNTCCL1002 ) ","2023-09-21 01:32:34","DDL1698262685","Deduction","C5945921","","35.40","6037.39"
"748","TCCL1002 - KUMAR CABLE NETWORK ( TNTDNTCCL1002 ) ","2023-09-21 01:32:34","DDL1698262690","Deduction","C5945921","","84.61","5952.78"
"749","TCCL1002 - KUMAR CABLE NETWORK ( TNTDNTCCL1002 ) ","2023-09-21 01:32:35","DDL1698262710","Deduction","C1676810","","35.40","5917.38"
"750","TCCL1002 - KUMAR CABLE NETWORK ( TNTDNTCCL1002 ) ","2023-09-21 01:32:35","DDL1698262715","Deduction","C1676810","","84.61","5832.77"
"751","TCCL1002 - KUMAR CABLE NETWORK ( TNTDNTCCL1002 ) ","2023-09-21 01:32:35","DDL1698262735","Deduction","C1291194","","35.40","5797.37"
"752","TCCL1002 - KUMAR CABLE NETWORK ( TNTDNTCCL1002 ) ","2023-09-21 01:32:35","DDL1698262740","Deduction","C1291194","","84.61","5712.76"
"753","TCCL1002 - KUMAR CABLE NETWORK ( TNTDNTCCL1002 ) ","2023-09-21 11:41:59","DDL1701367146","Deduction","C1495999","","11.80","5700.96"
"754","TCCL1002 - KUMAR CABLE NETWORK ( TNTDNTCCL1002 ) ","2023-09-21 11:41:59","DDL1701367151","Deduction","C1495999","","28.20","5672.76"
"755","TCCL1002 - KUMAR CABLE NETWORK ( TNTDNTCCL1002 ) ","2023-09-21 11:41:59","DDL1701367156","Deduction","C1495999","","21.24","5651.52"
"756","TCCL1002 - KUMAR CABLE NETWORK ( TNTDNTCCL1002 ) ","2023-09-21 11:41:59","DDL1701367161","Deduction","C1495999","","50.76","5600.76"
"757","TCCL1002 - KUMAR CABLE NETWORK ( TNTDNTCCL1002 ) ","2023-09-21 19:04:09","DDL1702813141","Deduction","C1496001","","11.80","5588.96"
"758","TCCL1002 - KUMAR CABLE NETWORK ( TNTDNTCCL1002 ) ","2023-09-21 19:04:16","DDL1702813216","Deduction","C1496001","","28.20","5560.76"
"759","TCCL1002 - KUMAR CABLE NETWORK ( TNTDNTCCL1002 ) ","2023-09-21 19:04:26","DDL1702813351","Deduction","C1496001","","21.24","5539.52"
"760","TCCL1002 - KUMAR CABLE NETWORK ( TNTDNTCCL1002 ) ","2023-09-21 19:04:31","DDL1702813401","Deduction","C1496001","","50.76","5488.76"
"761","TCCL1002 - KUMAR CABLE NETWORK ( TNTDNTCCL1002 ) ","2023-09-22 20:39:02","DDL1705579093","Deduction","C6725457","","10.62","5478.14"
"762","TCCL1002 - KUMAR CABLE NETWORK ( TNTDNTCCL1002 ) ","2023-09-22 20:39:02","DDL1705579098","Deduction","C6725457","","25.40","5452.74"
"763","TCCL1002 - KUMAR CABLE NETWORK ( TNTDNTCCL1002 ) ","2023-09-24 18:48:12","DDL1708350253","Deduction","C2266457","","8.26","5444.48"
"764","TCCL1002 - KUMAR CABLE NETWORK ( TNTDNTCCL1002 ) ","2023-09-24 18:48:12","DDL1708350258","Deduction","C2266457","","19.75","5424.73"
"765","TCCL1002 - KUMAR CABLE NETWORK ( TNTDNTCCL1002 ) ","2023-09-27 20:18:30","DDL1711438748","Deduction","C10349797","","4.72","5420.01"
"766","TCCL1002 - KUMAR CABLE NETWORK ( TNTDNTCCL1002 ) ","2023-09-27 20:18:30","DDL1711438753","Deduction","C10349797","","11.28","5408.73"
"767","TCCL1002 - KUMAR CABLE NETWORK ( TNTDNTCCL1002 ) ","2023-09-27 20:18:30","DDL1711438758","Deduction","C10349797","","21.24","5387.49"
"768","TCCL1002 - KUMAR CABLE NETWORK ( TNTDNTCCL1002 ) ","2023-09-27 20:18:30","DDL1711438763","Deduction","C10349797","","50.76","5336.73"
"769","TCCL1002 - KUMAR CABLE NETWORK ( TNTDNTCCL1002 ) ","2023-09-28 19:00:40","DDL1711757512","Deduction","C1237806","","3.54","5333.19"
"770","TCCL1002 - KUMAR CABLE NETWORK ( TNTDNTCCL1002 ) ","2023-09-28 19:00:40","DDL1711757517","Deduction","C1237806","","8.46","5324.73"
"771","TCCL1002 - KUMAR CABLE NETWORK ( TNTDNTCCL1002 ) ","2023-10-01 14:17:41","DDL1712455925","Deduction","C2266442","","35.40","5289.33"
"772","TCCL1002 - KUMAR CABLE NETWORK ( TNTDNTCCL1002 ) ","2023-10-01 14:17:41","DDL1712455930","Deduction","C2266442","","84.61","5204.72"
"773","TCCL1002 - KUMAR CABLE NETWORK ( TNTDNTCCL1002 ) ","2023-10-01 19:27:47","DDL1712536133","Deduction","C4300554","","35.40","5169.32"
"774","TCCL1002 - KUMAR CABLE NETWORK ( TNTDNTCCL1002 ) ","2023-10-01 19:27:47","DDL1712536138","Deduction","C4300554","","84.61","5084.71"
"775","TCCL1002 - KUMAR CABLE NETWORK ( TNTDNTCCL1002 ) ","2023-10-01 19:27:47","DDL1712536143","Deduction","C4300554","","20.18","5064.53"
"776","TCCL1002 - KUMAR CABLE NETWORK ( TNTDNTCCL1002 ) ","2023-10-05 15:44:32","TR18885892","Adjustment (classic sd pack discount 140*5 sep 2023) ","","700.00","","5764.53"
"777","TCCL1002 - KUMAR CABLE NETWORK ( TNTDNTCCL1002 ) ","2023-10-07 10:39:17","DDL1713476765","Deduction","C4073642","","28.55","5735.98"
"778","TCCL1002 - KUMAR CABLE NETWORK ( TNTDNTCCL1002 ) ","2023-10-07 10:39:17","DDL1713476769","Deduction","C4073642","","68.23","5667.75"
"779","TCCL1002 - KUMAR CABLE NETWORK ( TNTDNTCCL1002 ) ","2023-10-07 10:39:17","DDL1713476773","Deduction","C4073642","","16.52","5651.23"
"780","TCCL1002 - KUMAR CABLE NETWORK ( TNTDNTCCL1002 ) ","2023-10-07 10:39:17","DDL1713476777","Deduction","C4073642","","39.48","5611.75"
"781","TCCL1002 - KUMAR CABLE NETWORK ( TNTDNTCCL1002 ) ","2023-10-09 13:53:15","TR18931180","Adjustment (credit note for october-2023 life time stb ncf bill(1*35.40)) ","","35.40","","5647.15"
"782","TCCL1002 - KUMAR CABLE NETWORK ( TNTDNTCCL1002 ) ","2023-10-09 14:06:25","DDL1713960293","Deduction","C5714740","","35.40","5611.75"
"783","TCCL1002 - KUMAR CABLE NETWORK ( TNTDNTCCL1002 ) ","2023-10-09 19:02:42","DDL1714096137","Deduction","C1250634","","26.27","5585.48"
"784","TCCL1002 - KUMAR CABLE NETWORK ( TNTDNTCCL1002 ) ","2023-10-09 19:02:42","DDL1714096141","Deduction","C1250634","","62.78","5522.7"
"785","TCCL1002 - KUMAR CABLE NETWORK ( TNTDNTCCL1002 ) ","2023-10-09 19:02:42","DDL1714096145","Deduction","C1250634","","21.24","5501.46"
"786","TCCL1002 - KUMAR CABLE NETWORK ( TNTDNTCCL1002 ) ","2023-10-09 19:02:42","DDL1714096149","Deduction","C1250634","","50.76","5450.7"
"787","TCCL1002 - KUMAR CABLE NETWORK ( TNTDNTCCL1002 ) ","2023-10-15 13:32:13","DDL1716805378","Deduction","C6351898","","19.42","5431.28"
"788","TCCL1002 - KUMAR CABLE NETWORK ( TNTDNTCCL1002 ) ","2023-10-15 13:32:13","DDL1716805382","Deduction","C6351898","","46.41","5384.87"
"789","TCCL1002 - KUMAR CABLE NETWORK ( TNTDNTCCL1002 ) ","2023-10-15 13:32:13","DDL1716805386","Deduction","C6351898","","21.24","5363.63"
"790","TCCL1002 - KUMAR CABLE NETWORK ( TNTDNTCCL1002 ) ","2023-10-15 13:32:13","DDL1716805390","Deduction","C6351898","","50.76","5312.87"
"791","TCCL1002 - KUMAR CABLE NETWORK ( TNTDNTCCL1002 ) ","2023-10-18 08:01:24","DDL1717893158","Deduction","C5130819","","15.99","5296.88"
"792","TCCL1002 - KUMAR CABLE NETWORK ( TNTDNTCCL1002 ) ","2023-10-18 08:01:24","DDL1717893161","Deduction","C5130819","","38.20","5258.68"
"793","TCCL1002 - KUMAR CABLE NETWORK ( TNTDNTCCL1002 ) ","2023-10-18 08:01:24","DDL1717893164","Deduction","C5130819","","21.24","5237.44"
"794","TCCL1002 - KUMAR CABLE NETWORK ( TNTDNTCCL1002 ) ","2023-10-18 08:01:24","DDL1717893167","Deduction","C5130819","","50.76","5186.68"
"795","TCCL1002 - KUMAR CABLE NETWORK ( TNTDNTCCL1002 ) ","2023-10-19 14:58:05","TR19062881","Normal Deposit (Lco Amount Deposited from Lco Portal. Paytm payment with Ref No- RC_rwZKWP) ","","10000.00","","15186.68"
"796","TCCL1002 - KUMAR CABLE NETWORK ( TNTDNTCCL1002 ) ","2023-10-20 08:48:05","TR19088515","Normal Deposit (Lco Amount Deposited from Lco Portal. EASEBUZZ payment with Ref No- RC_nL14Nx) ","","9000.00","","24186.68"
"797","TCCL1002 - KUMAR CABLE NETWORK ( TNTDNTCCL1002 ) ","2023-10-20 08:55:40","DDL1721998567","Deduction","C0757509","","35.40","24151.28"
"798","TCCL1002 - KUMAR CABLE NETWORK ( TNTDNTCCL1002 ) ","2023-10-20 08:55:40","DDL1721998571","Deduction","C0757509","","84.61","24066.67"
"799","TCCL1002 - KUMAR CABLE NETWORK ( TNTDNTCCL1002 ) ","2023-10-20 08:55:40","DDL1721998579","Deduction","C1432101","","35.40","24031.27"
"800","TCCL1002 - KUMAR CABLE NETWORK ( TNTDNTCCL1002 ) ","2023-10-20 08:55:40","DDL1721998583","Deduction","C1432101","","84.61","23946.66"
"801","TCCL1002 - KUMAR CABLE NETWORK ( TNTDNTCCL1002 ) ","2023-10-20 08:55:40","DDL1721998591","Deduction","C3896312","","35.40","23911.26"
"802","TCCL1002 - KUMAR CABLE NETWORK ( TNTDNTCCL1002 ) ","2023-10-20 08:55:40","DDL1721998595","Deduction","C3896312","","84.61","23826.65"
"803","TCCL1002 - KUMAR CABLE NETWORK ( TNTDNTCCL1002 ) ","2023-10-20 08:55:40","DDL1721998603","Deduction","C1238666","","35.40","23791.25"
"804","TCCL1002 - KUMAR CABLE NETWORK ( TNTDNTCCL1002 ) ","2023-10-20 08:55:40","DDL1721998607","Deduction","C1238666","","84.61","23706.64"
"805","TCCL1002 - KUMAR CABLE NETWORK ( TNTDNTCCL1002 ) ","2023-10-20 08:55:40","DDL1721998615","Deduction","C2227396","","35.40","23671.24"
"806","TCCL1002 - KUMAR CABLE NETWORK ( TNTDNTCCL1002 ) ","2023-10-20 08:55:40","DDL1721998619","Deduction","C2227396","","84.61","23586.63"
"807","TCCL1002 - KUMAR CABLE NETWORK ( TNTDNTCCL1002 ) ","2023-10-20 08:55:40","DDL1721998623","Deduction","C1437253","","35.40","23551.23"
"808","TCCL1002 - KUMAR CABLE NETWORK ( TNTDNTCCL1002 ) ","2023-10-20 08:55:40","DDL1721998627","Deduction","C1437253","","84.61","23466.62"
"809","TCCL1002 - KUMAR CABLE NETWORK ( TNTDNTCCL1002 ) ","2023-10-20 08:55:40","DDL1721998631","Deduction","C6267661","","35.40","23431.22"
"810","TCCL1002 - KUMAR CABLE NETWORK ( TNTDNTCCL1002 ) ","2023-10-20 08:55:40","DDL1721998635","Deduction","C6267661","","84.61","23346.61"
"811","TCCL1002 - KUMAR CABLE NETWORK ( TNTDNTCCL1002 ) ","2023-10-20 08:55:41","DDL1721998639","Deduction","C1468102","","35.40","23311.21"
"812","TCCL1002 - KUMAR CABLE NETWORK ( TNTDNTCCL1002 ) ","2023-10-20 08:55:41","DDL1721998643","Deduction","C1468102","","84.61","23226.6"
"813","TCCL1002 - KUMAR CABLE NETWORK ( TNTDNTCCL1002 ) ","2023-10-20 08:55:41","DDL1721998647","Deduction","C1427120","","35.40","23191.2"
"814","TCCL1002 - KUMAR CABLE NETWORK ( TNTDNTCCL1002 ) ","2023-10-20 08:55:41","DDL1721998651","Deduction","C1427120","","84.61","23106.59"
"815","TCCL1002 - KUMAR CABLE NETWORK ( TNTDNTCCL1002 ) ","2023-10-20 08:55:41","DDL1721998659","Deduction","C1554612","","35.40","23071.19"
"816","TCCL1002 - KUMAR CABLE NETWORK ( TNTDNTCCL1002 ) ","2023-10-20 08:55:41","DDL1721998663","Deduction","C1554612","","84.61","22986.58"
"817","TCCL1002 - KUMAR CABLE NETWORK ( TNTDNTCCL1002 ) ","2023-10-20 08:55:41","DDL1721998671","Deduction","C5684330","","35.40","22951.18"
"818","TCCL1002 - KUMAR CABLE NETWORK ( TNTDNTCCL1002 ) ","2023-10-20 08:55:41","DDL1721998675","Deduction","C5684330","","84.61","22866.57"
"819","TCCL1002 - KUMAR CABLE NETWORK ( TNTDNTCCL1002 ) ","2023-10-20 08:55:41","DDL1721998683","Deduction","C1693303","","35.40","22831.17"
"820","TCCL1002 - KUMAR CABLE NETWORK ( TNTDNTCCL1002 ) ","2023-10-20 08:55:41","DDL1721998687","Deduction","C1693303","","84.61","22746.56"
"821","TCCL1002 - KUMAR CABLE NETWORK ( TNTDNTCCL1002 ) ","2023-10-20 08:55:41","DDL1721998691","Deduction","C2161413","","35.40","22711.16"
"822","TCCL1002 - KUMAR CABLE NETWORK ( TNTDNTCCL1002 ) ","2023-10-20 08:55:41","DDL1721998695","Deduction","C2161413","","84.61","22626.55"
"823","TCCL1002 - KUMAR CABLE NETWORK ( TNTDNTCCL1002 ) ","2023-10-20 08:55:41","DDL1721998703","Deduction","C6287282","","35.40","22591.15"
"824","TCCL1002 - KUMAR CABLE NETWORK ( TNTDNTCCL1002 ) ","2023-10-20 08:55:41","DDL1721998707","Deduction","C6287282","","84.61","22506.54"
"825","TCCL1002 - KUMAR CABLE NETWORK ( TNTDNTCCL1002 ) ","2023-10-20 08:55:41","DDL1721998711","Deduction","C1426984","","35.40","22471.14"
"826","TCCL1002 - KUMAR CABLE NETWORK ( TNTDNTCCL1002 ) ","2023-10-20 08:55:41","DDL1721998715","Deduction","C1426984","","84.61","22386.53"
"827","TCCL1002 - KUMAR CABLE NETWORK ( TNTDNTCCL1002 ) ","2023-10-20 08:55:41","DDL1721998719","Deduction","C1426984","","20.18","22366.35"
"828","TCCL1002 - KUMAR CABLE NETWORK ( TNTDNTCCL1002 ) ","2023-10-20 08:55:41","DDL1721998723","Deduction","C1426984","","20.18","22346.17"
"829","TCCL1002 - KUMAR CABLE NETWORK ( TNTDNTCCL1002 ) ","2023-10-20 08:55:41","DDL1721998727","Deduction","C1426984","","20.18","22325.99"
"830","TCCL1002 - KUMAR CABLE NETWORK ( TNTDNTCCL1002 ) ","2023-10-20 08:55:41","DDL1721998731","Deduction","C1496002","","35.40","22290.59"
"831","TCCL1002 - KUMAR CABLE NETWORK ( TNTDNTCCL1002 ) ","2023-10-20 08:55:41","DDL1721998735","Deduction","C1496002","","84.61","22205.98"
"832","TCCL1002 - KUMAR CABLE NETWORK ( TNTDNTCCL1002 ) ","2023-10-20 08:55:41","DDL1721998739","Deduction","C1291196","","35.40","22170.58"
"833","TCCL1002 - KUMAR CABLE NETWORK ( TNTDNTCCL1002 ) ","2023-10-20 08:55:41","DDL1721998743","Deduction","C1291196","","84.61","22085.97"
"834","TCCL1002 - KUMAR CABLE NETWORK ( TNTDNTCCL1002 ) ","2023-10-20 08:55:41","DDL1721998751","Deduction","C2558795","","35.40","22050.57"
"835","TCCL1002 - KUMAR CABLE NETWORK ( TNTDNTCCL1002 ) ","2023-10-20 08:55:41","DDL1721998755","Deduction","C2558795","","84.61","21965.96"
"836","TCCL1002 - KUMAR CABLE NETWORK ( TNTDNTCCL1002 ) ","2023-10-20 08:55:41","DDL1721998759","Deduction","C12371501","","35.40","21930.56"
"837","TCCL1002 - KUMAR CABLE NETWORK ( TNTDNTCCL1002 ) ","2023-10-20 08:55:41","DDL1721998763","Deduction","C12371501","","84.61","21845.95"
"838","TCCL1002 - KUMAR CABLE NETWORK ( TNTDNTCCL1002 ) ","2023-10-20 08:55:41","DDL1721998767","Deduction","C5575416","","35.40","21810.55"
"839","TCCL1002 - KUMAR CABLE NETWORK ( TNTDNTCCL1002 ) ","2023-10-20 08:55:41","DDL1721998771","Deduction","C5575416","","84.61","21725.94"
"840","TCCL1002 - KUMAR CABLE NETWORK ( TNTDNTCCL1002 ) ","2023-10-20 08:55:41","DDL1721998779","Deduction","C1437301","","35.40","21690.54"
"841","TCCL1002 - KUMAR CABLE NETWORK ( TNTDNTCCL1002 ) ","2023-10-20 08:55:41","DDL1721998783","Deduction","C1437301","","84.61","21605.93"
"842","TCCL1002 - KUMAR CABLE NETWORK ( TNTDNTCCL1002 ) ","2023-10-20 08:55:41","DDL1721998791","Deduction","C1992670","","35.40","21570.53"
"843","TCCL1002 - KUMAR CABLE NETWORK ( TNTDNTCCL1002 ) ","2023-10-20 08:55:41","DDL1721998795","Deduction","C1992670","","84.61","21485.92"
"844","TCCL1002 - KUMAR CABLE NETWORK ( TNTDNTCCL1002 ) ","2023-10-20 08:55:41","DDL1721998803","Deduction","C0798097","","35.40","21450.52"
"845","TCCL1002 - KUMAR CABLE NETWORK ( TNTDNTCCL1002 ) ","2023-10-20 08:55:41","DDL1721998807","Deduction","C0798097","","84.61","21365.91"
"846","TCCL1002 - KUMAR CABLE NETWORK ( TNTDNTCCL1002 ) ","2023-10-20 08:55:41","DDL1721998811","Deduction","C1693300","","35.40","21330.51"
"847","TCCL1002 - KUMAR CABLE NETWORK ( TNTDNTCCL1002 ) ","2023-10-20 08:55:41","DDL1721998815","Deduction","C1693300","","84.61","21245.9"
"848","TCCL1002 - KUMAR CABLE NETWORK ( TNTDNTCCL1002 ) ","2023-10-20 08:55:41","DDL1721998819","Deduction","C1432102","","7.99","21237.91"
"849","TCCL1002 - KUMAR CABLE NETWORK ( TNTDNTCCL1002 ) ","2023-10-20 08:55:42","DDL1721998823","Deduction","C1432102","","19.11","21218.8"
"850","TCCL1002 - KUMAR CABLE NETWORK ( TNTDNTCCL1002 ) ","2023-10-20 08:55:42","DDL1721998827","Deduction","C1087161","","35.40","21183.4"
"851","TCCL1002 - KUMAR CABLE NETWORK ( TNTDNTCCL1002 ) ","2023-10-20 08:55:42","DDL1721998831","Deduction","C1087161","","124.60","21058.8"
"852","TCCL1002 - KUMAR CABLE NETWORK ( TNTDNTCCL1002 ) ","2023-10-20 08:55:42","DDL1721998839","Deduction","C3379807","","35.40","21023.4"
"853","TCCL1002 - KUMAR CABLE NETWORK ( TNTDNTCCL1002 ) ","2023-10-20 08:55:42","DDL1721998843","Deduction","C3379807","","84.61","20938.79"
"854","TCCL1002 - KUMAR CABLE NETWORK ( TNTDNTCCL1002 ) ","2023-10-20 08:55:42","DDL1721998851","Deduction","C7395841","","35.40","20903.39"
"855","TCCL1002 - KUMAR CABLE NETWORK ( TNTDNTCCL1002 ) ","2023-10-20 08:55:42","DDL1721998855","Deduction","C7395841","","84.61","20818.78"
"856","TCCL1002 - KUMAR CABLE NETWORK ( TNTDNTCCL1002 ) ","2023-10-20 08:55:42","DDL1721998863","Deduction","C2051654","","35.40","20783.38"
"857","TCCL1002 - KUMAR CABLE NETWORK ( TNTDNTCCL1002 ) ","2023-10-20 08:55:42","DDL1721998867","Deduction","C2051654","","84.61","20698.77"
"858","TCCL1002 - KUMAR CABLE NETWORK ( TNTDNTCCL1002 ) ","2023-10-20 08:55:42","DDL1721998875","Deduction","C1426720","","35.40","20663.37"
"859","TCCL1002 - KUMAR CABLE NETWORK ( TNTDNTCCL1002 ) ","2023-10-20 08:55:42","DDL1721998879","Deduction","C1426720","","84.61","20578.76"
"860","TCCL1002 - KUMAR CABLE NETWORK ( TNTDNTCCL1002 ) ","2023-10-20 08:55:42","DDL1721998883","Deduction","C1425593","","35.40","20543.36"
"861","TCCL1002 - KUMAR CABLE NETWORK ( TNTDNTCCL1002 ) ","2023-10-20 08:55:42","DDL1721998887","Deduction","C1425593","","84.61","20458.75"
"862","TCCL1002 - KUMAR CABLE NETWORK ( TNTDNTCCL1002 ) ","2023-10-20 08:55:42","DDL1721998891","Deduction","C1459332","","35.40","20423.35"
"863","TCCL1002 - KUMAR CABLE NETWORK ( TNTDNTCCL1002 ) ","2023-10-20 08:55:42","DDL1721998895","Deduction","C1459332","","84.61","20338.74"
"864","TCCL1002 - KUMAR CABLE NETWORK ( TNTDNTCCL1002 ) ","2023-10-20 08:55:42","DDL1721998899","Deduction","C2334200","","35.40","20303.34"
"865","TCCL1002 - KUMAR CABLE NETWORK ( TNTDNTCCL1002 ) ","2023-10-20 08:55:42","DDL1721998903","Deduction","C2334200","","84.61","20218.73"
"866","TCCL1002 - KUMAR CABLE NETWORK ( TNTDNTCCL1002 ) ","2023-10-20 08:55:42","DDL1721998911","Deduction","C1468093","","35.40","20183.33"
"867","TCCL1002 - KUMAR CABLE NETWORK ( TNTDNTCCL1002 ) ","2023-10-20 08:55:42","DDL1721998915","Deduction","C1468093","","84.61","20098.72"
"868","TCCL1002 - KUMAR CABLE NETWORK ( TNTDNTCCL1002 ) ","2023-10-20 08:55:42","DDL1721998923","Deduction","C1693302","","35.40","20063.32"
"869","TCCL1002 - KUMAR CABLE NETWORK ( TNTDNTCCL1002 ) ","2023-10-20 08:55:42","DDL1721998927","Deduction","C1693302","","84.61","19978.71"
"870","TCCL1002 - KUMAR CABLE NETWORK ( TNTDNTCCL1002 ) ","2023-10-20 08:55:42","DDL1721998935","Deduction","C1554615","","35.40","19943.31"
"871","TCCL1002 - KUMAR CABLE NETWORK ( TNTDNTCCL1002 ) ","2023-10-20 08:55:42","DDL1721998939","Deduction","C1554615","","84.61","19858.7"
"872","TCCL1002 - KUMAR CABLE NETWORK ( TNTDNTCCL1002 ) ","2023-10-20 08:55:42","DDL1721998943","Deduction","C5130647","","35.40","19823.3"
"873","TCCL1002 - KUMAR CABLE NETWORK ( TNTDNTCCL1002 ) ","2023-10-20 08:55:42","DDL1721998947","Deduction","C5130647","","84.61","19738.69"
"874","TCCL1002 - KUMAR CABLE NETWORK ( TNTDNTCCL1002 ) ","2023-10-20 08:55:42","DDL1721998951","Deduction","C5130647","","20.18","19718.51"
"875","TCCL1002 - KUMAR CABLE NETWORK ( TNTDNTCCL1002 ) ","2023-10-20 08:55:42","DDL1721998955","Deduction","C5130647","","20.18","19698.33"
"876","TCCL1002 - KUMAR CABLE NETWORK ( TNTDNTCCL1002 ) ","2023-10-20 08:55:42","DDL1721998959","Deduction","C5130647","","20.18","19678.15"
"877","TCCL1002 - KUMAR CABLE NETWORK ( TNTDNTCCL1002 ) ","2023-10-20 08:55:42","DDL1721998963","Deduction","C1495996","","35.40","19642.75"
"878","TCCL1002 - KUMAR CABLE NETWORK ( TNTDNTCCL1002 ) ","2023-10-20 08:55:42","DDL1721998967","Deduction","C1495996","","84.61","19558.14"
"879","TCCL1002 - KUMAR CABLE NETWORK ( TNTDNTCCL1002 ) ","2023-10-20 08:55:42","DDL1721998971","Deduction","C8916676","","35.40","19522.74"
"880","TCCL1002 - KUMAR CABLE NETWORK ( TNTDNTCCL1002 ) ","2023-10-20 08:55:42","DDL1721998975","Deduction","C8916676","","84.61","19438.13"
"881","TCCL1002 - KUMAR CABLE NETWORK ( TNTDNTCCL1002 ) ","2023-10-20 08:55:42","DDL1721998983","Deduction","C1448881","","35.40","19402.73"
"882","TCCL1002 - KUMAR CABLE NETWORK ( TNTDNTCCL1002 ) ","2023-10-20 08:55:42","DDL1721998987","Deduction","C1448881","","84.61","19318.12"
"883","TCCL1002 - KUMAR CABLE NETWORK ( TNTDNTCCL1002 ) ","2023-10-20 08:55:42","DDL1721998995","Deduction","C4993282","","35.40","19282.72"
"884","TCCL1002 - KUMAR CABLE NETWORK ( TNTDNTCCL1002 ) ","2023-10-20 08:55:42","DDL1721998999","Deduction","C4993282","","84.61","19198.11"
"885","TCCL1002 - KUMAR CABLE NETWORK ( TNTDNTCCL1002 ) ","2023-10-20 08:55:43","DDL1721999007","Deduction","C1468095","","35.40","19162.71"
"886","TCCL1002 - KUMAR CABLE NETWORK ( TNTDNTCCL1002 ) ","2023-10-20 08:55:43","DDL1721999011","Deduction","C1468095","","84.61","19078.1"
"887","TCCL1002 - KUMAR CABLE NETWORK ( TNTDNTCCL1002 ) ","2023-10-20 08:55:43","DDL1721999015","Deduction","C4183113","","35.40","19042.7"
"888","TCCL1002 - KUMAR CABLE NETWORK ( TNTDNTCCL1002 ) ","2023-10-20 08:55:43","DDL1721999019","Deduction","C4183113","","84.61","18958.09"
"889","TCCL1002 - KUMAR CABLE NETWORK ( TNTDNTCCL1002 ) ","2023-10-20 08:55:43","DDL1721999023","Deduction","C1291191","","35.40","18922.69"
"890","TCCL1002 - KUMAR CABLE NETWORK ( TNTDNTCCL1002 ) ","2023-10-20 08:55:43","DDL1721999027","Deduction","C1291191","","84.61","18838.08"
"891","TCCL1002 - KUMAR CABLE NETWORK ( TNTDNTCCL1002 ) ","2023-10-20 08:55:43","DDL1721999031","Deduction","C1427146","","35.40","18802.68"
"892","TCCL1002 - KUMAR CABLE NETWORK ( TNTDNTCCL1002 ) ","2023-10-20 08:55:43","DDL1721999035","Deduction","C1427146","","84.61","18718.07"
"893","TCCL1002 - KUMAR CABLE NETWORK ( TNTDNTCCL1002 ) ","2023-10-20 08:55:43","DDL1721999043","Deduction","C1237806","","35.40","18682.67"
"894","TCCL1002 - KUMAR CABLE NETWORK ( TNTDNTCCL1002 ) ","2023-10-20 08:55:43","DDL1721999047","Deduction","C1237806","","84.61","18598.06"
"895","TCCL1002 - KUMAR CABLE NETWORK ( TNTDNTCCL1002 ) ","2023-10-20 08:55:43","DDL1721999051","Deduction","C5056626","","35.40","18562.66"
"896","TCCL1002 - KUMAR CABLE NETWORK ( TNTDNTCCL1002 ) ","2023-10-20 08:55:43","DDL1721999055","Deduction","C5056626","","84.61","18478.05"
"897","TCCL1002 - KUMAR CABLE NETWORK ( TNTDNTCCL1002 ) ","2023-10-20 08:55:43","DDL1721999059","Deduction","C1468097","","35.40","18442.65"
"898","TCCL1002 - KUMAR CABLE NETWORK ( TNTDNTCCL1002 ) ","2023-10-20 08:55:43","DDL1721999063","Deduction","C1468097","","84.61","18358.04"
"899","TCCL1002 - KUMAR CABLE NETWORK ( TNTDNTCCL1002 ) ","2023-10-20 08:55:43","DDL1721999067","Deduction","C3737584","","35.40","18322.64"
"900","TCCL1002 - KUMAR CABLE NETWORK ( TNTDNTCCL1002 ) ","2023-10-20 08:55:43","DDL1721999071","Deduction","C3737584","","84.61","18238.03"
"901","TCCL1002 - KUMAR CABLE NETWORK ( TNTDNTCCL1002 ) ","2023-10-20 08:55:43","DDL1721999075","Deduction","C1468101","","35.40","18202.63"
"902","TCCL1002 - KUMAR CABLE NETWORK ( TNTDNTCCL1002 ) ","2023-10-20 08:55:43","DDL1721999079","Deduction","C1468101","","84.61","18118.02"
"903","TCCL1002 - KUMAR CABLE NETWORK ( TNTDNTCCL1002 ) ","2023-10-20 08:55:43","DDL1721999087","Deduction","C2149806","","35.40","18082.62"
"904","TCCL1002 - KUMAR CABLE NETWORK ( TNTDNTCCL1002 ) ","2023-10-20 08:55:43","DDL1721999091","Deduction","C2149806","","84.61","17998.01"
"905","TCCL1002 - KUMAR CABLE NETWORK ( TNTDNTCCL1002 ) ","2023-10-20 08:55:43","DDL1721999095","Deduction","C1427055","","35.40","17962.61"
"906","TCCL1002 - KUMAR CABLE NETWORK ( TNTDNTCCL1002 ) ","2023-10-20 08:55:43","DDL1721999099","Deduction","C1427055","","84.61","17878"
"907","TCCL1002 - KUMAR CABLE NETWORK ( TNTDNTCCL1002 ) ","2023-10-20 08:55:43","DDL1721999103","Deduction","C12213465","","35.40","17842.6"
"908","TCCL1002 - KUMAR CABLE NETWORK ( TNTDNTCCL1002 ) ","2023-10-20 08:55:43","DDL1721999107","Deduction","C12213465","","84.61","17757.99"
"909","TCCL1002 - KUMAR CABLE NETWORK ( TNTDNTCCL1002 ) ","2023-10-20 08:55:43","DDL1721999111","Deduction","C1427641","","35.40","17722.59"
"910","TCCL1002 - KUMAR CABLE NETWORK ( TNTDNTCCL1002 ) ","2023-10-20 08:55:43","DDL1721999115","Deduction","C1427641","","84.61","17637.98"
"911","TCCL1002 - KUMAR CABLE NETWORK ( TNTDNTCCL1002 ) ","2023-10-20 08:55:43","DDL1721999119","Deduction","C1432090","","35.40","17602.58"
"912","TCCL1002 - KUMAR CABLE NETWORK ( TNTDNTCCL1002 ) ","2023-10-20 08:55:43","DDL1721999123","Deduction","C1432090","","84.61","17517.97"
"913","TCCL1002 - KUMAR CABLE NETWORK ( TNTDNTCCL1002 ) ","2023-10-20 08:55:43","DDL1721999127","Deduction","C1244143","","35.40","17482.57"
"914","TCCL1002 - KUMAR CABLE NETWORK ( TNTDNTCCL1002 ) ","2023-10-20 08:55:43","DDL1721999131","Deduction","C1244143","","84.61","17397.96"
"915","TCCL1002 - KUMAR CABLE NETWORK ( TNTDNTCCL1002 ) ","2023-10-20 08:55:43","DDL1721999135","Deduction","C4300560","","35.40","17362.56"
"916","TCCL1002 - KUMAR CABLE NETWORK ( TNTDNTCCL1002 ) ","2023-10-20 08:55:43","DDL1721999139","Deduction","C4300560","","84.61","17277.95"
"917","TCCL1002 - KUMAR CABLE NETWORK ( TNTDNTCCL1002 ) ","2023-10-20 08:55:44","DDL1721999143","Deduction","C3875743","","35.40","17242.55"
"918","TCCL1002 - KUMAR CABLE NETWORK ( TNTDNTCCL1002 ) ","2023-10-20 08:55:44","DDL1721999147","Deduction","C3875743","","84.61","17157.94"
"919","TCCL1002 - KUMAR CABLE NETWORK ( TNTDNTCCL1002 ) ","2023-10-20 08:55:44","DDL1721999151","Deduction","C1459352","","35.40","17122.54"
"920","TCCL1002 - KUMAR CABLE NETWORK ( TNTDNTCCL1002 ) ","2023-10-20 08:55:44","DDL1721999155","Deduction","C1459352","","84.61","17037.93"
"921","TCCL1002 - KUMAR CABLE NETWORK ( TNTDNTCCL1002 ) ","2023-10-20 08:55:44","DDL1721999159","Deduction","C4300548","","35.40","17002.53"
"922","TCCL1002 - KUMAR CABLE NETWORK ( TNTDNTCCL1002 ) ","2023-10-20 08:55:44","DDL1721999163","Deduction","C4300548","","84.61","16917.92"
"923","TCCL1002 - KUMAR CABLE NETWORK ( TNTDNTCCL1002 ) ","2023-10-20 08:55:44","DDL1721999167","Deduction","C0769247","","35.40","16882.52"
"924","TCCL1002 - KUMAR CABLE NETWORK ( TNTDNTCCL1002 ) ","2023-10-20 08:55:44","DDL1721999171","Deduction","C0769247","","84.61","16797.91"
"925","TCCL1002 - KUMAR CABLE NETWORK ( TNTDNTCCL1002 ) ","2023-10-20 08:55:44","DDL1721999175","Deduction","C0756488","","35.40","16762.51"
"926","TCCL1002 - KUMAR CABLE NETWORK ( TNTDNTCCL1002 ) ","2023-10-20 08:55:44","DDL1721999179","Deduction","C0756488","","84.61","16677.9"
"927","TCCL1002 - KUMAR CABLE NETWORK ( TNTDNTCCL1002 ) ","2023-10-20 08:55:44","DDL1721999191","Deduction","C3342594","","35.40","16642.5"
"928","TCCL1002 - KUMAR CABLE NETWORK ( TNTDNTCCL1002 ) ","2023-10-20 08:55:44","DDL1721999195","Deduction","C3342594","","84.61","16557.89"
"929","TCCL1002 - KUMAR CABLE NETWORK ( TNTDNTCCL1002 ) ","2023-10-20 08:55:44","DDL1721999199","Deduction","C1437360","","35.40","16522.49"
"930","TCCL1002 - KUMAR CABLE NETWORK ( TNTDNTCCL1002 ) ","2023-10-20 08:55:44","DDL1721999203","Deduction","C1437360","","84.61","16437.88"
"931","TCCL1002 - KUMAR CABLE NETWORK ( TNTDNTCCL1002 ) ","2023-10-20 08:55:44","DDL1721999207","Deduction","C2334438","","35.40","16402.48"
"932","TCCL1002 - KUMAR CABLE NETWORK ( TNTDNTCCL1002 ) ","2023-10-20 08:55:44","DDL1721999211","Deduction","C2334438","","84.61","16317.87"
"933","TCCL1002 - KUMAR CABLE NETWORK ( TNTDNTCCL1002 ) ","2023-10-20 08:55:44","DDL1721999215","Deduction","C0769358","","35.40","16282.47"
"934","TCCL1002 - KUMAR CABLE NETWORK ( TNTDNTCCL1002 ) ","2023-10-20 08:55:44","DDL1721999219","Deduction","C0769358","","84.61","16197.86"
"935","TCCL1002 - KUMAR CABLE NETWORK ( TNTDNTCCL1002 ) ","2023-10-20 08:55:44","DDL1721999223","Deduction","C7832592","","35.40","16162.46"
"936","TCCL1002 - KUMAR CABLE NETWORK ( TNTDNTCCL1002 ) ","2023-10-20 08:55:44","DDL1721999227","Deduction","C7832592","","84.61","16077.85"
"937","TCCL1002 - KUMAR CABLE NETWORK ( TNTDNTCCL1002 ) ","2023-10-20 08:55:44","DDL1721999231","Deduction","C4184972","","35.40","16042.45"
"938","TCCL1002 - KUMAR CABLE NETWORK ( TNTDNTCCL1002 ) ","2023-10-20 08:55:44","DDL1721999235","Deduction","C4184972","","84.61","15957.84"
"939","TCCL1002 - KUMAR CABLE NETWORK ( TNTDNTCCL1002 ) ","2023-10-20 08:55:44","DDL1721999239","Deduction","C6144382","","35.40","15922.44"
"940","TCCL1002 - KUMAR CABLE NETWORK ( TNTDNTCCL1002 ) ","2023-10-20 08:55:44","DDL1721999243","Deduction","C6144382","","84.61","15837.83"
"941","TCCL1002 - KUMAR CABLE NETWORK ( TNTDNTCCL1002 ) ","2023-10-20 08:55:44","DDL1721999247","Deduction","C1693301","","35.40","15802.43"
"942","TCCL1002 - KUMAR CABLE NETWORK ( TNTDNTCCL1002 ) ","2023-10-20 08:55:44","DDL1721999251","Deduction","C1693301","","124.60","15677.83"
"943","TCCL1002 - KUMAR CABLE NETWORK ( TNTDNTCCL1002 ) ","2023-10-20 08:55:44","DDL1721999255","Deduction","C2120530","","35.40","15642.43"
"944","TCCL1002 - KUMAR CABLE NETWORK ( TNTDNTCCL1002 ) ","2023-10-20 08:55:44","DDL1721999259","Deduction","C2120530","","84.61","15557.82"
"945","TCCL1002 - KUMAR CABLE NETWORK ( TNTDNTCCL1002 ) ","2023-10-20 08:55:44","DDL1721999263","Deduction","C1427006","","35.40","15522.42"
"946","TCCL1002 - KUMAR CABLE NETWORK ( TNTDNTCCL1002 ) ","2023-10-20 08:55:44","DDL1721999267","Deduction","C1427006","","84.61","15437.81"
"947","TCCL1002 - KUMAR CABLE NETWORK ( TNTDNTCCL1002 ) ","2023-10-20 08:55:44","DDL1721999271","Deduction","C5076832","","35.40","15402.41"
"948","TCCL1002 - KUMAR CABLE NETWORK ( TNTDNTCCL1002 ) ","2023-10-20 08:55:44","DDL1721999275","Deduction","C5076832","","84.61","15317.8"
"949","TCCL1002 - KUMAR CABLE NETWORK ( TNTDNTCCL1002 ) ","2023-10-20 08:55:44","DDL1721999279","Deduction","C1554617","","35.40","15282.4"
"950","TCCL1002 - KUMAR CABLE NETWORK ( TNTDNTCCL1002 ) ","2023-10-20 08:55:45","DDL1721999283","Deduction","C1554617","","84.61","15197.79"
"951","TCCL1002 - KUMAR CABLE NETWORK ( TNTDNTCCL1002 ) ","2023-10-20 08:55:45","DDL1721999287","Deduction","C1554069","","35.40","15162.39"
"952","TCCL1002 - KUMAR CABLE NETWORK ( TNTDNTCCL1002 ) ","2023-10-20 08:55:45","DDL1721999291","Deduction","C1554069","","84.61","15077.78"
"953","TCCL1002 - KUMAR CABLE NETWORK ( TNTDNTCCL1002 ) ","2023-10-20 08:55:45","DDL1721999295","Deduction","C1010021","","35.40","15042.38"
"954","TCCL1002 - KUMAR CABLE NETWORK ( TNTDNTCCL1002 ) ","2023-10-20 08:55:45","DDL1721999299","Deduction","C1010021","","84.61","14957.77"
"955","TCCL1002 - KUMAR CABLE NETWORK ( TNTDNTCCL1002 ) ","2023-10-20 08:55:45","DDL1721999303","Deduction","C11942814","","35.40","14922.37"
"956","TCCL1002 - KUMAR CABLE NETWORK ( TNTDNTCCL1002 ) ","2023-10-20 08:55:45","DDL1721999307","Deduction","C11942814","","84.61","14837.76"
"957","TCCL1002 - KUMAR CABLE NETWORK ( TNTDNTCCL1002 ) ","2023-10-20 08:55:45","DDL1721999311","Deduction","C5146791","","35.40","14802.36"
"958","TCCL1002 - KUMAR CABLE NETWORK ( TNTDNTCCL1002 ) ","2023-10-20 08:55:45","DDL1721999315","Deduction","C5146791","","84.61","14717.75"
"959","TCCL1002 - KUMAR CABLE NETWORK ( TNTDNTCCL1002 ) ","2023-10-20 08:55:45","DDL1721999319","Deduction","C8719391","","35.40","14682.35"
"960","TCCL1002 - KUMAR CABLE NETWORK ( TNTDNTCCL1002 ) ","2023-10-20 08:55:45","DDL1721999323","Deduction","C8719391","","84.61","14597.74"
"961","TCCL1002 - KUMAR CABLE NETWORK ( TNTDNTCCL1002 ) ","2023-10-20 08:55:45","DDL1721999327","Deduction","C1676819","","35.40","14562.34"
"962","TCCL1002 - KUMAR CABLE NETWORK ( TNTDNTCCL1002 ) ","2023-10-20 08:55:45","DDL1721999331","Deduction","C1676819","","84.61","14477.73"
"963","TCCL1002 - KUMAR CABLE NETWORK ( TNTDNTCCL1002 ) ","2023-10-20 08:55:45","DDL1721999335","Deduction","C1459282","","35.40","14442.33"
"964","TCCL1002 - KUMAR CABLE NETWORK ( TNTDNTCCL1002 ) ","2023-10-20 08:55:45","DDL1721999339","Deduction","C1459282","","84.61","14357.72"
"965","TCCL1002 - KUMAR CABLE NETWORK ( TNTDNTCCL1002 ) ","2023-10-20 08:55:45","DDL1721999343","Deduction","C1291192","","35.40","14322.32"
"966","TCCL1002 - KUMAR CABLE NETWORK ( TNTDNTCCL1002 ) ","2023-10-20 08:55:45","DDL1721999347","Deduction","C1291192","","84.61","14237.71"
"967","TCCL1002 - KUMAR CABLE NETWORK ( TNTDNTCCL1002 ) ","2023-10-20 08:55:45","DDL1721999351","Deduction","C4300557","","35.40","14202.31"
"968","TCCL1002 - KUMAR CABLE NETWORK ( TNTDNTCCL1002 ) ","2023-10-20 08:55:45","DDL1721999355","Deduction","C4300557","","84.61","14117.7"
"969","TCCL1002 - KUMAR CABLE NETWORK ( TNTDNTCCL1002 ) ","2023-10-20 08:55:45","DDL1721999359","Deduction","C6725457","","35.40","14082.3"
"970","TCCL1002 - KUMAR CABLE NETWORK ( TNTDNTCCL1002 ) ","2023-10-20 08:55:45","DDL1721999363","Deduction","C6725457","","84.61","13997.69"
"971","TCCL1002 - KUMAR CABLE NETWORK ( TNTDNTCCL1002 ) ","2023-10-20 08:55:45","DDL1721999371","Deduction","C1468096","","35.40","13962.29"
"972","TCCL1002 - KUMAR CABLE NETWORK ( TNTDNTCCL1002 ) ","2023-10-20 08:55:45","DDL1721999375","Deduction","C1468096","","84.61","13877.68"
"973","TCCL1002 - KUMAR CABLE NETWORK ( TNTDNTCCL1002 ) ","2023-10-20 08:55:45","DDL1721999383","Deduction","C3341959","","35.40","13842.28"
"974","TCCL1002 - KUMAR CABLE NETWORK ( TNTDNTCCL1002 ) ","2023-10-20 08:55:45","DDL1721999391","Deduction","C3341959","","84.61","13757.67"
"975","TCCL1002 - KUMAR CABLE NETWORK ( TNTDNTCCL1002 ) ","2023-10-20 08:55:45","DDL1721999395","Deduction","C4083997","","35.40","13722.27"
"976","TCCL1002 - KUMAR CABLE NETWORK ( TNTDNTCCL1002 ) ","2023-10-20 08:55:45","DDL1721999399","Deduction","C4083997","","84.61","13637.66"
"977","TCCL1002 - KUMAR CABLE NETWORK ( TNTDNTCCL1002 ) ","2023-10-20 08:55:45","DDL1721999403","Deduction","C3066959","","35.40","13602.26"
"978","TCCL1002 - KUMAR CABLE NETWORK ( TNTDNTCCL1002 ) ","2023-10-20 08:55:45","DDL1721999407","Deduction","C3066959","","124.60","13477.66"
"979","TCCL1002 - KUMAR CABLE NETWORK ( TNTDNTCCL1002 ) ","2023-10-20 08:55:45","DDL1721999411","Deduction","C1448873","","35.40","13442.26"
"980","TCCL1002 - KUMAR CABLE NETWORK ( TNTDNTCCL1002 ) ","2023-10-20 08:55:45","DDL1721999415","Deduction","C1448873","","84.61","13357.65"
"981","TCCL1002 - KUMAR CABLE NETWORK ( TNTDNTCCL1002 ) ","2023-10-20 08:55:45","DDL1721999419","Deduction","C2112697","","35.40","13322.25"
"982","TCCL1002 - KUMAR CABLE NETWORK ( TNTDNTCCL1002 ) ","2023-10-20 08:55:45","DDL1721999423","Deduction","C2112697","","84.61","13237.64"
"983","TCCL1002 - KUMAR CABLE NETWORK ( TNTDNTCCL1002 ) ","2023-10-20 08:55:46","DDL1721999427","Deduction","C8151612","","35.40","13202.24"
"984","TCCL1002 - KUMAR CABLE NETWORK ( TNTDNTCCL1002 ) ","2023-10-20 08:55:46","DDL1721999431","Deduction","C8151612","","84.61","13117.63"
"985","TCCL1002 - KUMAR CABLE NETWORK ( TNTDNTCCL1002 ) ","2023-10-20 08:55:46","DDL1721999435","Deduction","C2361951","","35.40","13082.23"
"986","TCCL1002 - KUMAR CABLE NETWORK ( TNTDNTCCL1002 ) ","2023-10-20 08:55:46","DDL1721999439","Deduction","C2361951","","84.61","12997.62"
"987","TCCL1002 - KUMAR CABLE NETWORK ( TNTDNTCCL1002 ) ","2023-10-20 08:55:46","DDL1721999443","Deduction","C1554616","","35.40","12962.22"
"988","TCCL1002 - KUMAR CABLE NETWORK ( TNTDNTCCL1002 ) ","2023-10-20 08:55:46","DDL1721999447","Deduction","C1554616","","84.61","12877.61"
"989","TCCL1002 - KUMAR CABLE NETWORK ( TNTDNTCCL1002 ) ","2023-10-20 08:55:46","DDL1721999451","Deduction","C1449005","","35.40","12842.21"
"990","TCCL1002 - KUMAR CABLE NETWORK ( TNTDNTCCL1002 ) ","2023-10-20 08:55:46","DDL1721999455","Deduction","C1449005","","84.61","12757.6"
"991","TCCL1002 - KUMAR CABLE NETWORK ( TNTDNTCCL1002 ) ","2023-10-20 08:55:46","DDL1721999459","Deduction","C7419138","","35.40","12722.2"
"992","TCCL1002 - KUMAR CABLE NETWORK ( TNTDNTCCL1002 ) ","2023-10-20 08:55:46","DDL1721999463","Deduction","C7419138","","84.61","12637.59"
"993","TCCL1002 - KUMAR CABLE NETWORK ( TNTDNTCCL1002 ) ","2023-10-20 08:55:46","DDL1721999467","Deduction","C2266457","","35.40","12602.19"
"994","TCCL1002 - KUMAR CABLE NETWORK ( TNTDNTCCL1002 ) ","2023-10-20 08:55:46","DDL1721999471","Deduction","C2266457","","84.61","12517.58"
"995","TCCL1002 - KUMAR CABLE NETWORK ( TNTDNTCCL1002 ) ","2023-10-20 08:55:46","DDL1721999475","Deduction","C7346395","","35.40","12482.18"
"996","TCCL1002 - KUMAR CABLE NETWORK ( TNTDNTCCL1002 ) ","2023-10-20 08:55:46","DDL1721999479","Deduction","C7346395","","84.61","12397.57"
"997","TCCL1002 - KUMAR CABLE NETWORK ( TNTDNTCCL1002 ) ","2023-10-20 08:55:46","DDL1721999483","Deduction","C9246684","","35.40","12362.17"
"998","TCCL1002 - KUMAR CABLE NETWORK ( TNTDNTCCL1002 ) ","2023-10-20 08:55:46","DDL1721999487","Deduction","C9246684","","84.61","12277.56"
"999","TCCL1002 - KUMAR CABLE NETWORK ( TNTDNTCCL1002 ) ","2023-10-20 08:55:46","DDL1721999491","Deduction","C2051430","","35.40","12242.16"
"1000","TCCL1002 - KUMAR CABLE NETWORK ( TNTDNTCCL1002 ) ","2023-10-20 08:55:46","DDL1721999495","Deduction","C2051430","","84.61","12157.55"
"1001","TCCL1002 - KUMAR CABLE NETWORK ( TNTDNTCCL1002 ) ","2023-10-20 08:55:46","DDL1721999499","Deduction","C1495997","","35.40","12122.15"
"1002","TCCL1002 - KUMAR CABLE NETWORK ( TNTDNTCCL1002 ) ","2023-10-20 08:55:46","DDL1721999503","Deduction","C1495997","","84.61","12037.54"
"1003","TCCL1002 - KUMAR CABLE NETWORK ( TNTDNTCCL1002 ) ","2023-10-20 08:55:46","DDL1721999507","Deduction","C0912432","","35.40","12002.14"
"1004","TCCL1002 - KUMAR CABLE NETWORK ( TNTDNTCCL1002 ) ","2023-10-20 08:55:46","DDL1721999511","Deduction","C0912432","","84.61","11917.53"
"1005","TCCL1002 - KUMAR CABLE NETWORK ( TNTDNTCCL1002 ) ","2023-10-20 08:55:46","DDL1721999523","Deduction","C12335179","","35.40","11882.13"
"1006","TCCL1002 - KUMAR CABLE NETWORK ( TNTDNTCCL1002 ) ","2023-10-20 08:55:46","DDL1721999527","Deduction","C12335179","","84.61","11797.52"
"1007","TCCL1002 - KUMAR CABLE NETWORK ( TNTDNTCCL1002 ) ","2023-10-20 08:55:46","DDL1721999531","Deduction","C2253859","","35.40","11762.12"
"1008","TCCL1002 - KUMAR CABLE NETWORK ( TNTDNTCCL1002 ) ","2023-10-20 08:55:46","DDL1721999535","Deduction","C2253859","","84.61","11677.51"
"1009","TCCL1002 - KUMAR CABLE NETWORK ( TNTDNTCCL1002 ) ","2023-10-20 08:55:46","DDL1721999539","Deduction","C3913039","","35.40","11642.11"
"1010","TCCL1002 - KUMAR CABLE NETWORK ( TNTDNTCCL1002 ) ","2023-10-20 08:55:46","DDL1721999543","Deduction","C3913039","","84.61","11557.5"
"1011","TCCL1002 - KUMAR CABLE NETWORK ( TNTDNTCCL1002 ) ","2023-10-20 08:55:46","DDL1721999547","Deduction","C1427096","","35.40","11522.1"
"1012","TCCL1002 - KUMAR CABLE NETWORK ( TNTDNTCCL1002 ) ","2023-10-20 08:55:46","DDL1721999551","Deduction","C1427096","","84.61","11437.49"
"1013","TCCL1002 - KUMAR CABLE NETWORK ( TNTDNTCCL1002 ) ","2023-10-20 08:55:46","DDL1721999555","Deduction","C1291197","","35.40","11402.09"
"1014","TCCL1002 - KUMAR CABLE NETWORK ( TNTDNTCCL1002 ) ","2023-10-20 08:55:46","DDL1721999559","Deduction","C1291197","","84.61","11317.48"
"1015","TCCL1002 - KUMAR CABLE NETWORK ( TNTDNTCCL1002 ) ","2023-10-20 08:55:46","DDL1721999563","Deduction","C1101626","","35.40","11282.08"
"1016","TCCL1002 - KUMAR CABLE NETWORK ( TNTDNTCCL1002 ) ","2023-10-20 08:55:46","DDL1721999567","Deduction","C1101626","","84.61","11197.47"
"1017","TCCL1002 - KUMAR CABLE NETWORK ( TNTDNTCCL1002 ) ","2023-10-20 08:55:47","DDL1721999571","Deduction","C1426504","","35.40","11162.07"
"1018","TCCL1002 - KUMAR CABLE NETWORK ( TNTDNTCCL1002 ) ","2023-10-20 08:55:47","DDL1721999575","Deduction","C1426504","","84.61","11077.46"
"1019","TCCL1002 - KUMAR CABLE NETWORK ( TNTDNTCCL1002 ) ","2023-10-20 08:55:47","DDL1721999579","Deduction","C0798159","","35.40","11042.06"
"1020","TCCL1002 - KUMAR CABLE NETWORK ( TNTDNTCCL1002 ) ","2023-10-20 08:55:47","DDL1721999583","Deduction","C0798159","","84.61","10957.45"
"1021","TCCL1002 - KUMAR CABLE NETWORK ( TNTDNTCCL1002 ) ","2023-10-20 08:55:47","DDL1721999587","Deduction","C2558743","","35.40","10922.05"
"1022","TCCL1002 - KUMAR CABLE NETWORK ( TNTDNTCCL1002 ) ","2023-10-20 08:55:47","DDL1721999591","Deduction","C2558743","","84.61","10837.44"
"1023","TCCL1002 - KUMAR CABLE NETWORK ( TNTDNTCCL1002 ) ","2023-10-20 08:55:47","DDL1721999607","Deduction","C5143534","","35.40","10802.04"
"1024","TCCL1002 - KUMAR CABLE NETWORK ( TNTDNTCCL1002 ) ","2023-10-20 08:55:47","DDL1721999611","Deduction","C5143534","","84.61","10717.43"
"1025","TCCL1002 - KUMAR CABLE NETWORK ( TNTDNTCCL1002 ) ","2023-10-20 08:55:47","DDL1721999619","Deduction","C1554067","","35.40","10682.03"
"1026","TCCL1002 - KUMAR CABLE NETWORK ( TNTDNTCCL1002 ) ","2023-10-20 08:55:47","DDL1721999623","Deduction","C1554067","","84.61","10597.42"
"1027","TCCL1002 - KUMAR CABLE NETWORK ( TNTDNTCCL1002 ) ","2023-10-20 08:55:47","DDL1721999627","Deduction","C0912367","","35.40","10562.02"
"1028","TCCL1002 - KUMAR CABLE NETWORK ( TNTDNTCCL1002 ) ","2023-10-20 08:55:47","DDL1721999631","Deduction","C0912367","","84.61","10477.41"
"1029","TCCL1002 - KUMAR CABLE NETWORK ( TNTDNTCCL1002 ) ","2023-10-20 08:55:47","DDL1721999635","Deduction","C4810648","","35.40","10442.01"
"1030","TCCL1002 - KUMAR CABLE NETWORK ( TNTDNTCCL1002 ) ","2023-10-20 08:55:47","DDL1721999639","Deduction","C4810648","","84.61","10357.4"
"1031","TCCL1002 - KUMAR CABLE NETWORK ( TNTDNTCCL1002 ) ","2023-10-20 08:55:47","DDL1721999643","Deduction","C10956878","","35.40","10322"
"1032","TCCL1002 - KUMAR CABLE NETWORK ( TNTDNTCCL1002 ) ","2023-10-20 08:55:47","DDL1721999647","Deduction","C10956878","","84.61","10237.39"
"1033","TCCL1002 - KUMAR CABLE NETWORK ( TNTDNTCCL1002 ) ","2023-10-20 08:55:47","DDL1721999651","Deduction","C1554611","","35.40","10201.99"
"1034","TCCL1002 - KUMAR CABLE NETWORK ( TNTDNTCCL1002 ) ","2023-10-20 08:55:47","DDL1721999655","Deduction","C1554611","","84.61","10117.38"
"1035","TCCL1002 - KUMAR CABLE NETWORK ( TNTDNTCCL1002 ) ","2023-10-20 08:55:47","DDL1721999659","Deduction","C1432096","","35.40","10081.98"
"1036","TCCL1002 - KUMAR CABLE NETWORK ( TNTDNTCCL1002 ) ","2023-10-20 08:55:47","DDL1721999663","Deduction","C1432096","","84.61","9997.37"
"1037","TCCL1002 - KUMAR CABLE NETWORK ( TNTDNTCCL1002 ) ","2023-10-20 08:55:47","DDL1721999667","Deduction","C1437289","","35.40","9961.97"
"1038","TCCL1002 - KUMAR CABLE NETWORK ( TNTDNTCCL1002 ) ","2023-10-20 08:55:47","DDL1721999671","Deduction","C1437289","","84.61","9877.36"
"1039","TCCL1002 - KUMAR CABLE NETWORK ( TNTDNTCCL1002 ) ","2023-10-20 08:55:47","DDL1721999675","Deduction","C0777090","","35.40","9841.96"
"1040","TCCL1002 - KUMAR CABLE NETWORK ( TNTDNTCCL1002 ) ","2023-10-20 08:55:47","DDL1721999679","Deduction","C0777090","","84.61","9757.35"
"1041","TCCL1002 - KUMAR CABLE NETWORK ( TNTDNTCCL1002 ) ","2023-10-20 08:55:47","DDL1721999683","Deduction","C1437320","","35.40","9721.95"
"1042","TCCL1002 - KUMAR CABLE NETWORK ( TNTDNTCCL1002 ) ","2023-10-20 08:55:47","DDL1721999687","Deduction","C1437320","","84.61","9637.34"
"1043","TCCL1002 - KUMAR CABLE NETWORK ( TNTDNTCCL1002 ) ","2023-10-20 08:55:47","DDL1721999691","Deduction","C1425806","","35.40","9601.94"
"1044","TCCL1002 - KUMAR CABLE NETWORK ( TNTDNTCCL1002 ) ","2023-10-20 08:55:47","DDL1721999695","Deduction","C1425806","","84.61","9517.33"
"1045","TCCL1002 - KUMAR CABLE NETWORK ( TNTDNTCCL1002 ) ","2023-10-20 08:55:47","DDL1721999703","Deduction","C0756480","","35.40","9481.93"
"1046","TCCL1002 - KUMAR CABLE NETWORK ( TNTDNTCCL1002 ) ","2023-10-20 08:55:47","DDL1721999707","Deduction","C0756480","","84.61","9397.32"
"1047","TCCL1002 - KUMAR CABLE NETWORK ( TNTDNTCCL1002 ) ","2023-10-20 08:55:47","DDL1721999711","Deduction","C0839779","","35.40","9361.92"
"1048","TCCL1002 - KUMAR CABLE NETWORK ( TNTDNTCCL1002 ) ","2023-10-20 08:55:47","DDL1721999715","Deduction","C0839779","","84.61","9277.31"
"1049","TCCL1002 - KUMAR CABLE NETWORK ( TNTDNTCCL1002 ) ","2023-10-20 08:55:48","DDL1721999719","Deduction","C1449004","","35.40","9241.91"
"1050","TCCL1002 - KUMAR CABLE NETWORK ( TNTDNTCCL1002 ) ","2023-10-20 08:55:48","DDL1721999723","Deduction","C1449004","","84.61","9157.3"
"1051","TCCL1002 - KUMAR CABLE NETWORK ( TNTDNTCCL1002 ) ","2023-10-20 08:55:48","DDL1721999727","Deduction","C5527136","","35.40","9121.9"
"1052","TCCL1002 - KUMAR CABLE NETWORK ( TNTDNTCCL1002 ) ","2023-10-20 08:55:48","DDL1721999731","Deduction","C5527136","","84.61","9037.29"
"1053","TCCL1002 - KUMAR CABLE NETWORK ( TNTDNTCCL1002 ) ","2023-10-20 08:55:48","DDL1721999735","Deduction","C1267818","","35.40","9001.89"
"1054","TCCL1002 - KUMAR CABLE NETWORK ( TNTDNTCCL1002 ) ","2023-10-20 08:55:48","DDL1721999739","Deduction","C1267818","","84.61","8917.28"
"1055","TCCL1002 - KUMAR CABLE NETWORK ( TNTDNTCCL1002 ) ","2023-10-20 08:55:48","DDL1721999743","Deduction","C10349797","","35.40","8881.88"
"1056","TCCL1002 - KUMAR CABLE NETWORK ( TNTDNTCCL1002 ) ","2023-10-20 08:55:48","DDL1721999747","Deduction","C10349797","","84.61","8797.27"
"1057","TCCL1002 - KUMAR CABLE NETWORK ( TNTDNTCCL1002 ) ","2023-10-20 08:55:48","DDL1721999751","Deduction","C0797263","","35.40","8761.87"
"1058","TCCL1002 - KUMAR CABLE NETWORK ( TNTDNTCCL1002 ) ","2023-10-20 08:55:48","DDL1721999755","Deduction","C0797263","","84.61","8677.26"
"1059","TCCL1002 - KUMAR CABLE NETWORK ( TNTDNTCCL1002 ) ","2023-10-20 08:55:48","DDL1721999759","Deduction","C1010622","","35.40","8641.86"
"1060","TCCL1002 - KUMAR CABLE NETWORK ( TNTDNTCCL1002 ) ","2023-10-20 08:55:48","DDL1721999763","Deduction","C1010622","","84.61","8557.25"
"1061","TCCL1002 - KUMAR CABLE NETWORK ( TNTDNTCCL1002 ) ","2023-10-20 08:55:48","DDL1721999767","Deduction","C5271559","","35.40","8521.85"
"1062","TCCL1002 - KUMAR CABLE NETWORK ( TNTDNTCCL1002 ) ","2023-10-20 08:55:48","DDL1721999771","Deduction","C5271559","","84.61","8437.24"
"1063","TCCL1002 - KUMAR CABLE NETWORK ( TNTDNTCCL1002 ) ","2023-10-20 08:55:48","DDL1721999775","Deduction","C0839942","","35.40","8401.84"
"1064","TCCL1002 - KUMAR CABLE NETWORK ( TNTDNTCCL1002 ) ","2023-10-20 08:55:48","DDL1721999779","Deduction","C0839942","","84.61","8317.23"
"1065","TCCL1002 - KUMAR CABLE NETWORK ( TNTDNTCCL1002 ) ","2023-10-20 08:55:48","DDL1721999783","Deduction","C0839767","","35.40","8281.83"
"1066","TCCL1002 - KUMAR CABLE NETWORK ( TNTDNTCCL1002 ) ","2023-10-20 08:55:48","DDL1721999787","Deduction","C0839767","","84.61","8197.22"
"1067","TCCL1002 - KUMAR CABLE NETWORK ( TNTDNTCCL1002 ) ","2023-10-20 08:55:48","DDL1721999791","Deduction","C2957470","","35.40","8161.82"
"1068","TCCL1002 - KUMAR CABLE NETWORK ( TNTDNTCCL1002 ) ","2023-10-20 08:55:48","DDL1721999795","Deduction","C2957470","","84.61","8077.21"
"1069","TCCL1002 - KUMAR CABLE NETWORK ( TNTDNTCCL1002 ) ","2023-10-20 08:55:48","DDL1721999799","Deduction","C6843192","","35.40","8041.81"
"1070","TCCL1002 - KUMAR CABLE NETWORK ( TNTDNTCCL1002 ) ","2023-10-20 08:55:48","DDL1721999803","Deduction","C6843192","","84.61","7957.2"
"1071","TCCL1002 - KUMAR CABLE NETWORK ( TNTDNTCCL1002 ) ","2023-10-20 08:55:48","DDL1721999807","Deduction","C2311055","","35.40","7921.8"
"1072","TCCL1002 - KUMAR CABLE NETWORK ( TNTDNTCCL1002 ) ","2023-10-20 08:55:48","DDL1721999811","Deduction","C2311055","","47.78","7874.02"
"1073","TCCL1002 - KUMAR CABLE NETWORK ( TNTDNTCCL1002 ) ","2023-10-20 08:55:48","DDL1721999815","Deduction","C1291195","","35.40","7838.62"
"1074","TCCL1002 - KUMAR CABLE NETWORK ( TNTDNTCCL1002 ) ","2023-10-20 08:55:48","DDL1721999819","Deduction","C1291195","","84.61","7754.01"
"1075","TCCL1002 - KUMAR CABLE NETWORK ( TNTDNTCCL1002 ) ","2023-10-20 08:55:48","DDL1721999823","Deduction","C0839950","","35.40","7718.61"
"1076","TCCL1002 - KUMAR CABLE NETWORK ( TNTDNTCCL1002 ) ","2023-10-20 08:55:48","DDL1721999827","Deduction","C0839950","","84.61","7634"
"1077","TCCL1002 - KUMAR CABLE NETWORK ( TNTDNTCCL1002 ) ","2023-10-20 08:55:48","DDL1721999831","Deduction","C2103869","","35.40","7598.6"
"1078","TCCL1002 - KUMAR CABLE NETWORK ( TNTDNTCCL1002 ) ","2023-10-20 08:55:48","DDL1721999835","Deduction","C2103869","","84.61","7513.99"
"1079","TCCL1002 - KUMAR CABLE NETWORK ( TNTDNTCCL1002 ) ","2023-10-20 08:55:48","DDL1721999839","Deduction","C10743576","","35.40","7478.59"
"1080","TCCL1002 - KUMAR CABLE NETWORK ( TNTDNTCCL1002 ) ","2023-10-20 08:55:48","DDL1721999843","Deduction","C10743576","","84.61","7393.98"
"1081","TCCL1002 - KUMAR CABLE NETWORK ( TNTDNTCCL1002 ) ","2023-10-20 08:55:49","DDL1721999847","Deduction","C2113643","","35.40","7358.58"
"1082","TCCL1002 - KUMAR CABLE NETWORK ( TNTDNTCCL1002 ) ","2023-10-20 08:55:49","DDL1721999851","Deduction","C2113643","","84.61","7273.97"
"1083","TCCL1002 - KUMAR CABLE NETWORK ( TNTDNTCCL1002 ) ","2023-10-20 08:55:49","DDL1721999855","Deduction","C7795023","","35.40","7238.57"
"1084","TCCL1002 - KUMAR CABLE NETWORK ( TNTDNTCCL1002 ) ","2023-10-20 08:55:49","DDL1721999859","Deduction","C7795023","","84.61","7153.96"
"1085","TCCL1002 - KUMAR CABLE NETWORK ( TNTDNTCCL1002 ) ","2023-10-20 08:55:49","DDL1721999867","Deduction","C1014398","","35.40","7118.56"
"1086","TCCL1002 - KUMAR CABLE NETWORK ( TNTDNTCCL1002 ) ","2023-10-20 08:55:49","DDL1721999871","Deduction","C1014398","","164.79","6953.77"
"1087","TCCL1002 - KUMAR CABLE NETWORK ( TNTDNTCCL1002 ) ","2023-10-20 08:55:49","DDL1721999875","Deduction","C1014398","","47.78","6905.99"
"1088","TCCL1002 - KUMAR CABLE NETWORK ( TNTDNTCCL1002 ) ","2023-10-20 08:55:49","DDL1721999879","Deduction","C1014398","","6.38","6899.61"
"1089","TCCL1002 - KUMAR CABLE NETWORK ( TNTDNTCCL1002 ) ","2023-10-20 08:55:49","DDL1721999883","Deduction","C1014398","","0.11","6899.5"
"1090","TCCL1002 - KUMAR CABLE NETWORK ( TNTDNTCCL1002 ) ","2023-10-20 08:55:49","DDL1721999891","Deduction","C5092149","","35.40","6864.1"
"1091","TCCL1002 - KUMAR CABLE NETWORK ( TNTDNTCCL1002 ) ","2023-10-20 08:55:49","DDL1721999895","Deduction","C5092149","","84.61","6779.49"
"1092","TCCL1002 - KUMAR CABLE NETWORK ( TNTDNTCCL1002 ) ","2023-10-20 08:55:49","DDL1721999903","Deduction","C1495999","","35.40","6744.09"
"1093","TCCL1002 - KUMAR CABLE NETWORK ( TNTDNTCCL1002 ) ","2023-10-20 08:55:49","DDL1721999907","Deduction","C1495999","","84.61","6659.48"
"1094","TCCL1002 - KUMAR CABLE NETWORK ( TNTDNTCCL1002 ) ","2023-10-20 08:55:49","DDL1721999915","Deduction","C2551645","","35.40","6624.08"
"1095","TCCL1002 - KUMAR CABLE NETWORK ( TNTDNTCCL1002 ) ","2023-10-20 08:55:49","DDL1721999919","Deduction","C2551645","","84.61","6539.47"
"1096","TCCL1002 - KUMAR CABLE NETWORK ( TNTDNTCCL1002 ) ","2023-10-20 08:55:49","DDL1721999927","Deduction","C1425705","","35.40","6504.07"
"1097","TCCL1002 - KUMAR CABLE NETWORK ( TNTDNTCCL1002 ) ","2023-10-20 08:55:49","DDL1721999931","Deduction","C1425705","","84.61","6419.46"
"1098","TCCL1002 - KUMAR CABLE NETWORK ( TNTDNTCCL1002 ) ","2023-10-20 08:55:49","DDL1721999939","Deduction","C1468098","","35.40","6384.06"
"1099","TCCL1002 - KUMAR CABLE NETWORK ( TNTDNTCCL1002 ) ","2023-10-20 08:55:49","DDL1721999943","Deduction","C1468098","","84.61","6299.45"
"1100","TCCL1002 - KUMAR CABLE NETWORK ( TNTDNTCCL1002 ) ","2023-10-20 08:55:49","DDL1721999947","Deduction","C5994050","","35.40","6264.05"
"1101","TCCL1002 - KUMAR CABLE NETWORK ( TNTDNTCCL1002 ) ","2023-10-20 08:55:49","DDL1721999951","Deduction","C5994050","","84.61","6179.44"
"1102","TCCL1002 - KUMAR CABLE NETWORK ( TNTDNTCCL1002 ) ","2023-10-20 08:55:49","DDL1721999955","Deduction","C6063433","","35.40","6144.04"
"1103","TCCL1002 - KUMAR CABLE NETWORK ( TNTDNTCCL1002 ) ","2023-10-20 08:55:49","DDL1721999959","Deduction","C6063433","","84.61","6059.43"
"1104","TCCL1002 - KUMAR CABLE NETWORK ( TNTDNTCCL1002 ) ","2023-10-20 08:55:49","DDL1721999963","Deduction","C9927995","","35.40","6024.03"
"1105","TCCL1002 - KUMAR CABLE NETWORK ( TNTDNTCCL1002 ) ","2023-10-20 08:55:49","DDL1721999967","Deduction","C9927995","","84.61","5939.42"
"1106","TCCL1002 - KUMAR CABLE NETWORK ( TNTDNTCCL1002 ) ","2023-10-20 08:55:55","DDL1722000159","Deduction","C2566372","","35.40","5904.02"
"1107","TCCL1002 - KUMAR CABLE NETWORK ( TNTDNTCCL1002 ) ","2023-10-20 08:55:55","DDL1722000163","Deduction","C2566372","","84.61","5819.41"
"1108","TCCL1002 - KUMAR CABLE NETWORK ( TNTDNTCCL1002 ) ","2023-10-20 08:55:55","DDL1722000167","Deduction","C12157796","","35.40","5784.01"
"1109","TCCL1002 - KUMAR CABLE NETWORK ( TNTDNTCCL1002 ) ","2023-10-20 08:55:55","DDL1722000171","Deduction","C12157796","","84.61","5699.4"
"1110","TCCL1002 - KUMAR CABLE NETWORK ( TNTDNTCCL1002 ) ","2023-10-20 08:55:55","DDL1722000183","Deduction","C1495995","","35.40","5664"
"1111","TCCL1002 - KUMAR CABLE NETWORK ( TNTDNTCCL1002 ) ","2023-10-20 08:55:55","DDL1722000187","Deduction","C1495995","","84.61","5579.39"
"1112","TCCL1002 - KUMAR CABLE NETWORK ( TNTDNTCCL1002 ) ","2023-10-20 08:55:55","DDL1722000191","Deduction","C1430868","","35.40","5543.99"
"1113","TCCL1002 - KUMAR CABLE NETWORK ( TNTDNTCCL1002 ) ","2023-10-20 08:55:55","DDL1722000195","Deduction","C1430868","","84.61","5459.38"
"1114","TCCL1002 - KUMAR CABLE NETWORK ( TNTDNTCCL1002 ) ","2023-10-20 08:55:55","DDL1722000199","Deduction","C1554614","","35.40","5423.98"
"1115","TCCL1002 - KUMAR CABLE NETWORK ( TNTDNTCCL1002 ) ","2023-10-20 08:55:55","DDL1722000203","Deduction","C1554614","","84.61","5339.37"
"1116","TCCL1002 - KUMAR CABLE NETWORK ( TNTDNTCCL1002 ) ","2023-10-20 08:55:55","DDL1722000207","Deduction","C1237951","","35.40","5303.97"
"1117","TCCL1002 - KUMAR CABLE NETWORK ( TNTDNTCCL1002 ) ","2023-10-20 08:55:55","DDL1722000211","Deduction","C1237951","","84.61","5219.36"
"1118","TCCL1002 - KUMAR CABLE NETWORK ( TNTDNTCCL1002 ) ","2023-10-20 08:55:55","DDL1722000215","Deduction","C6115333","","35.40","5183.96"
"1119","TCCL1002 - KUMAR CABLE NETWORK ( TNTDNTCCL1002 ) ","2023-10-20 08:55:55","DDL1722000219","Deduction","C6115333","","84.61","5099.35"
"1120","TCCL1002 - KUMAR CABLE NETWORK ( TNTDNTCCL1002 ) ","2023-10-20 08:55:55","DDL1722000223","Deduction","C1238016","","35.40","5063.95"
"1121","TCCL1002 - KUMAR CABLE NETWORK ( TNTDNTCCL1002 ) ","2023-10-20 08:55:55","DDL1722000227","Deduction","C1238016","","84.61","4979.34"
"1122","TCCL1002 - KUMAR CABLE NETWORK ( TNTDNTCCL1002 ) ","2023-10-20 08:55:56","DDL1722000231","Deduction","C5076993","","35.40","4943.94"
"1123","TCCL1002 - KUMAR CABLE NETWORK ( TNTDNTCCL1002 ) ","2023-10-20 08:55:56","DDL1722000235","Deduction","C5076993","","84.61","4859.33"
"1124","TCCL1002 - KUMAR CABLE NETWORK ( TNTDNTCCL1002 ) ","2023-10-20 08:55:56","DDL1722000239","Deduction","C1432094","","35.40","4823.93"
"1125","TCCL1002 - KUMAR CABLE NETWORK ( TNTDNTCCL1002 ) ","2023-10-20 08:55:56","DDL1722000243","Deduction","C1432094","","84.61","4739.32"
"1126","TCCL1002 - KUMAR CABLE NETWORK ( TNTDNTCCL1002 ) ","2023-10-20 08:55:56","DDL1722000247","Deduction","C1448871","","35.40","4703.92"
"1127","TCCL1002 - KUMAR CABLE NETWORK ( TNTDNTCCL1002 ) ","2023-10-20 08:55:56","DDL1722000251","Deduction","C1448871","","84.61","4619.31"
"1128","TCCL1002 - KUMAR CABLE NETWORK ( TNTDNTCCL1002 ) ","2023-10-20 08:55:56","DDL1722000255","Deduction","C5945921","","35.40","4583.91"
"1129","TCCL1002 - KUMAR CABLE NETWORK ( TNTDNTCCL1002 ) ","2023-10-20 08:55:56","DDL1722000259","Deduction","C5945921","","84.61","4499.3"
"1130","TCCL1002 - KUMAR CABLE NETWORK ( TNTDNTCCL1002 ) ","2023-10-20 08:55:56","DDL1722000263","Deduction","C12157930","","35.40","4463.9"
"1131","TCCL1002 - KUMAR CABLE NETWORK ( TNTDNTCCL1002 ) ","2023-10-20 08:55:56","DDL1722000267","Deduction","C12157930","","84.61","4379.29"
"1132","TCCL1002 - KUMAR CABLE NETWORK ( TNTDNTCCL1002 ) ","2023-10-20 08:55:56","DDL1722000271","Deduction","C1676810","","35.40","4343.89"
"1133","TCCL1002 - KUMAR CABLE NETWORK ( TNTDNTCCL1002 ) ","2023-10-20 08:55:56","DDL1722000275","Deduction","C1676810","","84.61","4259.28"
"1134","TCCL1002 - KUMAR CABLE NETWORK ( TNTDNTCCL1002 ) ","2023-10-20 08:55:56","DDL1722000279","Deduction","C1291194","","35.40","4223.88"
"1135","TCCL1002 - KUMAR CABLE NETWORK ( TNTDNTCCL1002 ) ","2023-10-20 08:55:56","DDL1722000283","Deduction","C1291194","","84.61","4139.27"
"1136","TCCL1002 - KUMAR CABLE NETWORK ( TNTDNTCCL1002 ) ","2023-10-22 17:27:10","DDL1727872596","Deduction","C6096709","","11.42","4127.85"
"1137","TCCL1002 - KUMAR CABLE NETWORK ( TNTDNTCCL1002 ) ","2023-10-22 17:27:10","DDL1727872600","Deduction","C6096709","","27.29","4100.56"
"1138","TCCL1002 - KUMAR CABLE NETWORK ( TNTDNTCCL1002 ) ","2023-10-22 17:27:11","DDL1727872604","Deduction","C6096709","","6.50","4094.06"
"1139","TCCL1002 - KUMAR CABLE NETWORK ( TNTDNTCCL1002 ) ","2023-11-06 14:05:21","TR19942649","Adjustment (classic sd pack discount 161*5 oct 2023) ","","805.00","","4899.06"
"1140","TCCL1002 - KUMAR CABLE NETWORK ( TNTDNTCCL1002 ) ","2023-11-06 21:51:35","DDL1738921749","Deduction","C1291193","","70.52","4828.54"
"1141","TCCL1002 - KUMAR CABLE NETWORK ( TNTDNTCCL1002 ) ","2023-11-06 21:51:36","DDL1738921754","Deduction","C1291193","","29.50","4799.04"
"1142","TCCL1002 - KUMAR CABLE NETWORK ( TNTDNTCCL1002 ) ","2023-11-06 21:51:36","DDL1738921759","Deduction","C1291193","","21.24","4777.8"
"1143","TCCL1002 - KUMAR CABLE NETWORK ( TNTDNTCCL1002 ) ","2023-11-06 21:51:36","DDL1738921764","Deduction","C1291193","","50.76","4727.04"
"1144","TCCL1002 - KUMAR CABLE NETWORK ( TNTDNTCCL1002 ) ","2023-11-07 19:30:45","DDL1739182639","Deduction","C1496001","","28.32","4698.72"
"1145","TCCL1002 - KUMAR CABLE NETWORK ( TNTDNTCCL1002 ) ","2023-11-07 19:30:45","DDL1739182644","Deduction","C1496001","","67.69","4631.03"
"1146","TCCL1002 - KUMAR CABLE NETWORK ( TNTDNTCCL1002 ) ","2023-11-10 14:52:18","TR20122072","Adjustment (credit note for november-2023 life time stb ncf bill(1*35.40)) ","","35.40","","4666.43"
"1147","TCCL1002 - KUMAR CABLE NETWORK ( TNTDNTCCL1002 ) ","2023-11-10 15:37:31","DDL1740112973","Deduction","C5714740","","35.40","4631.03"
"1148","TCCL1002 - KUMAR CABLE NETWORK ( TNTDNTCCL1002 ) ","2023-11-10 22:15:29","DDL1740355993","Deduction","C12826763","","24.78","4606.25"
"1149","TCCL1002 - KUMAR CABLE NETWORK ( TNTDNTCCL1002 ) ","2023-11-10 22:15:29","DDL1740355998","Deduction","C12826763","","59.24","4547.01"
"1150","TCCL1002 - KUMAR CABLE NETWORK ( TNTDNTCCL1002 ) ","2023-11-12 10:12:23","DDL1740945739","Deduction","C2149901","","22.42","4524.59"
"1151","TCCL1002 - KUMAR CABLE NETWORK ( TNTDNTCCL1002 ) ","2023-11-12 10:12:23","DDL1740945744","Deduction","C2149901","","53.60","4470.99"
"1152","TCCL1002 - KUMAR CABLE NETWORK ( TNTDNTCCL1002 ) ","2023-11-15 08:09:54","DDL1742223268","Deduction","C1425740","","18.88","4452.11"
"1153","TCCL1002 - KUMAR CABLE NETWORK ( TNTDNTCCL1002 ) ","2023-11-15 08:09:55","DDL1742223273","Deduction","C1425740","","45.12","4406.99"
"1154","TCCL1002 - KUMAR CABLE NETWORK ( TNTDNTCCL1002 ) ","2023-11-15 12:33:42","DDL1742423775","Deduction","C8122307","","18.88","4388.11"
"1155","TCCL1002 - KUMAR CABLE NETWORK ( TNTDNTCCL1002 ) ","2023-11-15 12:33:42","DDL1742423780","Deduction","C8122307","","45.12","4342.99"
"1156","TCCL1002 - KUMAR CABLE NETWORK ( TNTDNTCCL1002 ) ","2023-11-19 17:19:56","DDL1747777527","Deduction","C7787231","","14.16","4328.83"
"1157","TCCL1002 - KUMAR CABLE NETWORK ( TNTDNTCCL1002 ) ","2023-11-19 17:19:56","DDL1747777532","Deduction","C7787231","","33.84","4294.99"
"1158","TCCL1002 - KUMAR CABLE NETWORK ( TNTDNTCCL1002 ) ","2023-11-19 17:19:56","DDL1747777537","Deduction","C7787231","","21.24","4273.75"
"1159","TCCL1002 - KUMAR CABLE NETWORK ( TNTDNTCCL1002 ) ","2023-11-19 17:19:56","DDL1747777542","Deduction","C7787231","","50.76","4222.99"
"1160","TCCL1002 - KUMAR CABLE NETWORK ( TNTDNTCCL1002 ) ","2023-11-20 11:23:14","TR20419794","Normal Deposit (Lco Amount Deposited from Lco Portal. EASEBUZZ payment with Ref No- RC_kqxQhX) ","","20500.00","","24722.99"
"1161","TCCL1002 - KUMAR CABLE NETWORK ( TNTDNTCCL1002 ) ","2023-11-20 11:35:24","DDL1749476798","Deduction","C0757509","","35.40","24687.59"
"1162","TCCL1002 - KUMAR CABLE NETWORK ( TNTDNTCCL1002 ) ","2023-11-20 11:35:24","DDL1749476803","Deduction","C0757509","","84.61","24602.98"
"1163","TCCL1002 - KUMAR CABLE NETWORK ( TNTDNTCCL1002 ) ","2023-11-20 11:35:24","DDL1749476818","Deduction","C1250634","","35.40","24567.58"
"1164","TCCL1002 - KUMAR CABLE NETWORK ( TNTDNTCCL1002 ) ","2023-11-20 11:35:24","DDL1749476823","Deduction","C1250634","","84.61","24482.97"
"1165","TCCL1002 - KUMAR CABLE NETWORK ( TNTDNTCCL1002 ) ","2023-11-20 11:35:24","DDL1749476838","Deduction","C1432101","","35.40","24447.57"
"1166","TCCL1002 - KUMAR CABLE NETWORK ( TNTDNTCCL1002 ) ","2023-11-20 11:35:24","DDL1749476843","Deduction","C1432101","","84.61","24362.96"
"1167","TCCL1002 - KUMAR CABLE NETWORK ( TNTDNTCCL1002 ) ","2023-11-20 11:35:24","DDL1749476858","Deduction","C3896312","","35.40","24327.56"
"1168","TCCL1002 - KUMAR CABLE NETWORK ( TNTDNTCCL1002 ) ","2023-11-20 11:35:24","DDL1749476863","Deduction","C3896312","","84.61","24242.95"
"1169","TCCL1002 - KUMAR CABLE NETWORK ( TNTDNTCCL1002 ) ","2023-11-20 11:35:24","DDL1749476873","Deduction","C1238666","","35.40","24207.55"
"1170","TCCL1002 - KUMAR CABLE NETWORK ( TNTDNTCCL1002 ) ","2023-11-20 11:35:24","DDL1749476878","Deduction","C1238666","","84.61","24122.94"
"1171","TCCL1002 - KUMAR CABLE NETWORK ( TNTDNTCCL1002 ) ","2023-11-20 11:35:24","DDL1749476898","Deduction","C2227396","","35.40","24087.54"
"1172","TCCL1002 - KUMAR CABLE NETWORK ( TNTDNTCCL1002 ) ","2023-11-20 11:35:24","DDL1749476903","Deduction","C2227396","","84.61","24002.93"
"1173","TCCL1002 - KUMAR CABLE NETWORK ( TNTDNTCCL1002 ) ","2023-11-20 11:35:24","DDL1749476913","Deduction","C1437253","","35.40","23967.53"
"1174","TCCL1002 - KUMAR CABLE NETWORK ( TNTDNTCCL1002 ) ","2023-11-20 11:35:24","DDL1749476918","Deduction","C1437253","","84.61","23882.92"
"1175","TCCL1002 - KUMAR CABLE NETWORK ( TNTDNTCCL1002 ) ","2023-11-20 11:35:24","DDL1749476933","Deduction","C6267661","","35.40","23847.52"
"1176","TCCL1002 - KUMAR CABLE NETWORK ( TNTDNTCCL1002 ) ","2023-11-20 11:35:24","DDL1749476938","Deduction","C6267661","","84.61","23762.91"
"1177","TCCL1002 - KUMAR CABLE NETWORK ( TNTDNTCCL1002 ) ","2023-11-20 11:35:25","DDL1749476948","Deduction","C1468102","","35.40","23727.51"
"1178","TCCL1002 - KUMAR CABLE NETWORK ( TNTDNTCCL1002 ) ","2023-11-20 11:35:25","DDL1749476953","Deduction","C1468102","","84.61","23642.9"
"1179","TCCL1002 - KUMAR CABLE NETWORK ( TNTDNTCCL1002 ) ","2023-11-20 11:35:25","DDL1749476963","Deduction","C1427120","","35.40","23607.5"
"1180","TCCL1002 - KUMAR CABLE NETWORK ( TNTDNTCCL1002 ) ","2023-11-20 11:35:25","DDL1749476968","Deduction","C1427120","","84.61","23522.89"
"1181","TCCL1002 - KUMAR CABLE NETWORK ( TNTDNTCCL1002 ) ","2023-11-20 11:35:25","DDL1749476978","Deduction","C1554612","","35.40","23487.49"
"1182","TCCL1002 - KUMAR CABLE NETWORK ( TNTDNTCCL1002 ) ","2023-11-20 11:35:25","DDL1749476983","Deduction","C1554612","","84.61","23402.88"
"1183","TCCL1002 - KUMAR CABLE NETWORK ( TNTDNTCCL1002 ) ","2023-11-20 11:35:25","DDL1749476993","Deduction","C4300554","","35.40","23367.48"
"1184","TCCL1002 - KUMAR CABLE NETWORK ( TNTDNTCCL1002 ) ","2023-11-20 11:35:25","DDL1749476998","Deduction","C4300554","","84.61","23282.87"
"1185","TCCL1002 - KUMAR CABLE NETWORK ( TNTDNTCCL1002 ) ","2023-11-20 11:35:25","DDL1749477008","Deduction","C5684330","","35.40","23247.47"
"1186","TCCL1002 - KUMAR CABLE NETWORK ( TNTDNTCCL1002 ) ","2023-11-20 11:35:25","DDL1749477013","Deduction","C5684330","","84.61","23162.86"
"1187","TCCL1002 - KUMAR CABLE NETWORK ( TNTDNTCCL1002 ) ","2023-11-20 11:35:25","DDL1749477023","Deduction","C1693303","","35.40","23127.46"
"1188","TCCL1002 - KUMAR CABLE NETWORK ( TNTDNTCCL1002 ) ","2023-11-20 11:35:25","DDL1749477028","Deduction","C1693303","","84.61","23042.85"
"1189","TCCL1002 - KUMAR CABLE NETWORK ( TNTDNTCCL1002 ) ","2023-11-20 11:35:25","DDL1749477038","Deduction","C2161413","","35.40","23007.45"
"1190","TCCL1002 - KUMAR CABLE NETWORK ( TNTDNTCCL1002 ) ","2023-11-20 11:35:25","DDL1749477043","Deduction","C2161413","","84.61","22922.84"
"1191","TCCL1002 - KUMAR CABLE NETWORK ( TNTDNTCCL1002 ) ","2023-11-20 11:35:25","DDL1749477053","Deduction","C6287282","","35.40","22887.44"
"1192","TCCL1002 - KUMAR CABLE NETWORK ( TNTDNTCCL1002 ) ","2023-11-20 11:35:25","DDL1749477058","Deduction","C6287282","","84.61","22802.83"
"1193","TCCL1002 - KUMAR CABLE NETWORK ( TNTDNTCCL1002 ) ","2023-11-20 11:35:25","DDL1749477063","Deduction","C1426984","","35.40","22767.43"
"1194","TCCL1002 - KUMAR CABLE NETWORK ( TNTDNTCCL1002 ) ","2023-11-20 11:35:25","DDL1749477068","Deduction","C1426984","","84.61","22682.82"
"1195","TCCL1002 - KUMAR CABLE NETWORK ( TNTDNTCCL1002 ) ","2023-11-20 11:35:25","DDL1749477073","Deduction","C1426984","","20.18","22662.64"
"1196","TCCL1002 - KUMAR CABLE NETWORK ( TNTDNTCCL1002 ) ","2023-11-20 11:35:25","DDL1749477078","Deduction","C1426984","","20.18","22642.46"
"1197","TCCL1002 - KUMAR CABLE NETWORK ( TNTDNTCCL1002 ) ","2023-11-20 11:35:25","DDL1749477083","Deduction","C1426984","","20.18","22622.28"
"1198","TCCL1002 - KUMAR CABLE NETWORK ( TNTDNTCCL1002 ) ","2023-11-20 11:35:25","DDL1749477093","Deduction","C1496002","","35.40","22586.88"
"1199","TCCL1002 - KUMAR CABLE NETWORK ( TNTDNTCCL1002 ) ","2023-11-20 11:35:25","DDL1749477098","Deduction","C1496002","","84.61","22502.27"
"1200","TCCL1002 - KUMAR CABLE NETWORK ( TNTDNTCCL1002 ) ","2023-11-20 11:35:25","DDL1749477108","Deduction","C1291196","","35.40","22466.87"
"1201","TCCL1002 - KUMAR CABLE NETWORK ( TNTDNTCCL1002 ) ","2023-11-20 11:35:25","DDL1749477113","Deduction","C1291196","","84.61","22382.26"
"1202","TCCL1002 - KUMAR CABLE NETWORK ( TNTDNTCCL1002 ) ","2023-11-20 11:35:25","DDL1749477123","Deduction","C2558795","","35.40","22346.86"
"1203","TCCL1002 - KUMAR CABLE NETWORK ( TNTDNTCCL1002 ) ","2023-11-20 11:35:25","DDL1749477128","Deduction","C2558795","","84.61","22262.25"
"1204","TCCL1002 - KUMAR CABLE NETWORK ( TNTDNTCCL1002 ) ","2023-11-20 11:35:25","DDL1749477138","Deduction","C12371501","","35.40","22226.85"
"1205","TCCL1002 - KUMAR CABLE NETWORK ( TNTDNTCCL1002 ) ","2023-11-20 11:35:25","DDL1749477143","Deduction","C12371501","","84.61","22142.24"
"1206","TCCL1002 - KUMAR CABLE NETWORK ( TNTDNTCCL1002 ) ","2023-11-20 11:35:25","DDL1749477153","Deduction","C5575416","","35.40","22106.84"
"1207","TCCL1002 - KUMAR CABLE NETWORK ( TNTDNTCCL1002 ) ","2023-11-20 11:35:25","DDL1749477158","Deduction","C5575416","","84.61","22022.23"
"1208","TCCL1002 - KUMAR CABLE NETWORK ( TNTDNTCCL1002 ) ","2023-11-20 11:35:26","DDL1749477173","Deduction","C1437301","","35.40","21986.83"
"1209","TCCL1002 - KUMAR CABLE NETWORK ( TNTDNTCCL1002 ) ","2023-11-20 11:35:26","DDL1749477178","Deduction","C1437301","","84.61","21902.22"
"1210","TCCL1002 - KUMAR CABLE NETWORK ( TNTDNTCCL1002 ) ","2023-11-20 11:35:26","DDL1749477183","Deduction","C1992670","","35.40","21866.82"
"1211","TCCL1002 - KUMAR CABLE NETWORK ( TNTDNTCCL1002 ) ","2023-11-20 11:35:26","DDL1749477188","Deduction","C1992670","","84.61","21782.21"
"1212","TCCL1002 - KUMAR CABLE NETWORK ( TNTDNTCCL1002 ) ","2023-11-20 11:35:26","DDL1749477193","Deduction","C0798097","","35.40","21746.81"
"1213","TCCL1002 - KUMAR CABLE NETWORK ( TNTDNTCCL1002 ) ","2023-11-20 11:35:26","DDL1749477198","Deduction","C0798097","","84.61","21662.2"
"1214","TCCL1002 - KUMAR CABLE NETWORK ( TNTDNTCCL1002 ) ","2023-11-20 11:35:26","DDL1749477208","Deduction","C1693300","","35.40","21626.8"
"1215","TCCL1002 - KUMAR CABLE NETWORK ( TNTDNTCCL1002 ) ","2023-11-20 11:35:26","DDL1749477213","Deduction","C1693300","","84.61","21542.19"
"1216","TCCL1002 - KUMAR CABLE NETWORK ( TNTDNTCCL1002 ) ","2023-11-20 11:35:26","DDL1749477253","Deduction","C1010622","","11.80","21530.39"
"1217","TCCL1002 - KUMAR CABLE NETWORK ( TNTDNTCCL1002 ) ","2023-11-20 11:35:26","DDL1749477258","Deduction","C1010622","","28.20","21502.19"
"1218","TCCL1002 - KUMAR CABLE NETWORK ( TNTDNTCCL1002 ) ","2023-11-20 11:35:27","DDL1749477438","Deduction","C1010622","","12.98","21489.21"
"1219","TCCL1002 - KUMAR CABLE NETWORK ( TNTDNTCCL1002 ) ","2023-11-20 11:35:27","DDL1749477448","Deduction","C1010622","","31.03","21458.18"
"1220","TCCL1002 - KUMAR CABLE NETWORK ( TNTDNTCCL1002 ) ","2023-11-20 11:35:27","DDL1749477463","Deduction","C1087161","","35.40","21422.78"
"1221","TCCL1002 - KUMAR CABLE NETWORK ( TNTDNTCCL1002 ) ","2023-11-20 11:35:27","DDL1749477468","Deduction","C1087161","","124.60","21298.18"
"1222","TCCL1002 - KUMAR CABLE NETWORK ( TNTDNTCCL1002 ) ","2023-11-20 11:35:27","DDL1749477478","Deduction","C3379807","","35.40","21262.78"
"1223","TCCL1002 - KUMAR CABLE NETWORK ( TNTDNTCCL1002 ) ","2023-11-20 11:35:27","DDL1749477483","Deduction","C3379807","","84.61","21178.17"
"1224","TCCL1002 - KUMAR CABLE NETWORK ( TNTDNTCCL1002 ) ","2023-11-20 11:35:27","DDL1749477488","Deduction","C7395841","","35.40","21142.77"
"1225","TCCL1002 - KUMAR CABLE NETWORK ( TNTDNTCCL1002 ) ","2023-11-20 11:35:27","DDL1749477493","Deduction","C7395841","","84.61","21058.16"
"1226","TCCL1002 - KUMAR CABLE NETWORK ( TNTDNTCCL1002 ) ","2023-11-20 11:35:27","DDL1749477508","Deduction","C2051654","","35.40","21022.76"
"1227","TCCL1002 - KUMAR CABLE NETWORK ( TNTDNTCCL1002 ) ","2023-11-20 11:35:27","DDL1749477513","Deduction","C2051654","","84.61","20938.15"
"1228","TCCL1002 - KUMAR CABLE NETWORK ( TNTDNTCCL1002 ) ","2023-11-20 11:35:27","DDL1749477518","Deduction","C1426720","","35.40","20902.75"
"1229","TCCL1002 - KUMAR CABLE NETWORK ( TNTDNTCCL1002 ) ","2023-11-20 11:35:27","DDL1749477523","Deduction","C1426720","","84.61","20818.14"
"1230","TCCL1002 - KUMAR CABLE NETWORK ( TNTDNTCCL1002 ) ","2023-11-20 11:35:27","DDL1749477528","Deduction","C5130819","","35.40","20782.74"
"1231","TCCL1002 - KUMAR CABLE NETWORK ( TNTDNTCCL1002 ) ","2023-11-20 11:35:27","DDL1749477533","Deduction","C5130819","","84.61","20698.13"
"1232","TCCL1002 - KUMAR CABLE NETWORK ( TNTDNTCCL1002 ) ","2023-11-20 11:35:27","DDL1749477538","Deduction","C1425593","","35.40","20662.73"
"1233","TCCL1002 - KUMAR CABLE NETWORK ( TNTDNTCCL1002 ) ","2023-11-20 11:35:27","DDL1749477543","Deduction","C1425593","","84.61","20578.12"
"1234","TCCL1002 - KUMAR CABLE NETWORK ( TNTDNTCCL1002 ) ","2023-11-20 11:35:27","DDL1749477548","Deduction","C1459332","","35.40","20542.72"
"1235","TCCL1002 - KUMAR CABLE NETWORK ( TNTDNTCCL1002 ) ","2023-11-20 11:35:27","DDL1749477553","Deduction","C1459332","","84.61","20458.11"
"1236","TCCL1002 - KUMAR CABLE NETWORK ( TNTDNTCCL1002 ) ","2023-11-20 11:35:27","DDL1749477563","Deduction","C2334200","","35.40","20422.71"
"1237","TCCL1002 - KUMAR CABLE NETWORK ( TNTDNTCCL1002 ) ","2023-11-20 11:35:27","DDL1749477568","Deduction","C2334200","","84.61","20338.1"
"1238","TCCL1002 - KUMAR CABLE NETWORK ( TNTDNTCCL1002 ) ","2023-11-20 11:35:27","DDL1749477578","Deduction","C1468093","","35.40","20302.7"
"1239","TCCL1002 - KUMAR CABLE NETWORK ( TNTDNTCCL1002 ) ","2023-11-20 11:35:27","DDL1749477583","Deduction","C1468093","","84.61","20218.09"
"1240","TCCL1002 - KUMAR CABLE NETWORK ( TNTDNTCCL1002 ) ","2023-11-20 11:35:27","DDL1749477593","Deduction","C1693302","","35.40","20182.69"
"1241","TCCL1002 - KUMAR CABLE NETWORK ( TNTDNTCCL1002 ) ","2023-11-20 11:35:27","DDL1749477598","Deduction","C1693302","","84.61","20098.08"
"1242","TCCL1002 - KUMAR CABLE NETWORK ( TNTDNTCCL1002 ) ","2023-11-20 11:35:27","DDL1749477608","Deduction","C1554615","","35.40","20062.68"
"1243","TCCL1002 - KUMAR CABLE NETWORK ( TNTDNTCCL1002 ) ","2023-11-20 11:35:27","DDL1749477613","Deduction","C1554615","","84.61","19978.07"
"1244","TCCL1002 - KUMAR CABLE NETWORK ( TNTDNTCCL1002 ) ","2023-11-20 11:35:27","DDL1749477633","Deduction","C5130647","","35.40","19942.67"
"1245","TCCL1002 - KUMAR CABLE NETWORK ( TNTDNTCCL1002 ) ","2023-11-20 11:35:27","DDL1749477638","Deduction","C5130647","","84.61","19858.06"
"1246","TCCL1002 - KUMAR CABLE NETWORK ( TNTDNTCCL1002 ) ","2023-11-20 11:35:27","DDL1749477643","Deduction","C5130647","","20.18","19837.88"
"1247","TCCL1002 - KUMAR CABLE NETWORK ( TNTDNTCCL1002 ) ","2023-11-20 11:35:27","DDL1749477648","Deduction","C5130647","","20.18","19817.7"
"1248","TCCL1002 - KUMAR CABLE NETWORK ( TNTDNTCCL1002 ) ","2023-11-20 11:35:28","DDL1749477653","Deduction","C5130647","","20.18","19797.52"
"1249","TCCL1002 - KUMAR CABLE NETWORK ( TNTDNTCCL1002 ) ","2023-11-20 11:35:28","DDL1749477658","Deduction","C1495996","","35.40","19762.12"
"1250","TCCL1002 - KUMAR CABLE NETWORK ( TNTDNTCCL1002 ) ","2023-11-20 11:35:28","DDL1749477663","Deduction","C1495996","","84.61","19677.51"
"1251","TCCL1002 - KUMAR CABLE NETWORK ( TNTDNTCCL1002 ) ","2023-11-20 11:35:28","DDL1749477668","Deduction","C8916676","","35.40","19642.11"
"1252","TCCL1002 - KUMAR CABLE NETWORK ( TNTDNTCCL1002 ) ","2023-11-20 11:35:28","DDL1749477673","Deduction","C8916676","","84.61","19557.5"
"1253","TCCL1002 - KUMAR CABLE NETWORK ( TNTDNTCCL1002 ) ","2023-11-20 11:35:28","DDL1749477703","Deduction","C1448881","","35.40","19522.1"
"1254","TCCL1002 - KUMAR CABLE NETWORK ( TNTDNTCCL1002 ) ","2023-11-20 11:35:28","DDL1749477708","Deduction","C1448881","","84.61","19437.49"
"1255","TCCL1002 - KUMAR CABLE NETWORK ( TNTDNTCCL1002 ) ","2023-11-20 11:35:28","DDL1749477718","Deduction","C4993282","","35.40","19402.09"
"1256","TCCL1002 - KUMAR CABLE NETWORK ( TNTDNTCCL1002 ) ","2023-11-20 11:35:28","DDL1749477723","Deduction","C4993282","","84.61","19317.48"
"1257","TCCL1002 - KUMAR CABLE NETWORK ( TNTDNTCCL1002 ) ","2023-11-20 11:35:28","DDL1749477733","Deduction","C1468095","","35.40","19282.08"
"1258","TCCL1002 - KUMAR CABLE NETWORK ( TNTDNTCCL1002 ) ","2023-11-20 11:35:28","DDL1749477738","Deduction","C1468095","","84.61","19197.47"
"1259","TCCL1002 - KUMAR CABLE NETWORK ( TNTDNTCCL1002 ) ","2023-11-20 11:35:28","DDL1749477758","Deduction","C4183113","","35.40","19162.07"
"1260","TCCL1002 - KUMAR CABLE NETWORK ( TNTDNTCCL1002 ) ","2023-11-20 11:35:28","DDL1749477763","Deduction","C4183113","","84.61","19077.46"
"1261","TCCL1002 - KUMAR CABLE NETWORK ( TNTDNTCCL1002 ) ","2023-11-20 11:35:28","DDL1749477773","Deduction","C1291191","","35.40","19042.06"
"1262","TCCL1002 - KUMAR CABLE NETWORK ( TNTDNTCCL1002 ) ","2023-11-20 11:35:28","DDL1749477778","Deduction","C1291191","","84.61","18957.45"
"1263","TCCL1002 - KUMAR CABLE NETWORK ( TNTDNTCCL1002 ) ","2023-11-20 11:35:28","DDL1749477788","Deduction","C1427146","","35.40","18922.05"
"1264","TCCL1002 - KUMAR CABLE NETWORK ( TNTDNTCCL1002 ) ","2023-11-20 11:35:28","DDL1749477793","Deduction","C1427146","","84.61","18837.44"
"1265","TCCL1002 - KUMAR CABLE NETWORK ( TNTDNTCCL1002 ) ","2023-11-20 11:35:28","DDL1749477803","Deduction","C1237806","","35.40","18802.04"
"1266","TCCL1002 - KUMAR CABLE NETWORK ( TNTDNTCCL1002 ) ","2023-11-20 11:35:28","DDL1749477808","Deduction","C1237806","","84.61","18717.43"
"1267","TCCL1002 - KUMAR CABLE NETWORK ( TNTDNTCCL1002 ) ","2023-11-20 11:35:28","DDL1749477818","Deduction","C5056626","","35.40","18682.03"
"1268","TCCL1002 - KUMAR CABLE NETWORK ( TNTDNTCCL1002 ) ","2023-11-20 11:35:28","DDL1749477823","Deduction","C5056626","","84.61","18597.42"
"1269","TCCL1002 - KUMAR CABLE NETWORK ( TNTDNTCCL1002 ) ","2023-11-20 11:35:28","DDL1749477833","Deduction","C1468097","","35.40","18562.02"
"1270","TCCL1002 - KUMAR CABLE NETWORK ( TNTDNTCCL1002 ) ","2023-11-20 11:35:28","DDL1749477838","Deduction","C1468097","","84.61","18477.41"
"1271","TCCL1002 - KUMAR CABLE NETWORK ( TNTDNTCCL1002 ) ","2023-11-20 11:35:28","DDL1749477848","Deduction","C3737584","","35.40","18442.01"
"1272","TCCL1002 - KUMAR CABLE NETWORK ( TNTDNTCCL1002 ) ","2023-11-20 11:35:28","DDL1749477853","Deduction","C3737584","","84.61","18357.4"
"1273","TCCL1002 - KUMAR CABLE NETWORK ( TNTDNTCCL1002 ) ","2023-11-20 11:35:28","DDL1749477863","Deduction","C1468101","","35.40","18322"
"1274","TCCL1002 - KUMAR CABLE NETWORK ( TNTDNTCCL1002 ) ","2023-11-20 11:35:28","DDL1749477868","Deduction","C1468101","","84.61","18237.39"
"1275","TCCL1002 - KUMAR CABLE NETWORK ( TNTDNTCCL1002 ) ","2023-11-20 11:35:28","DDL1749477873","Deduction","C2149806","","35.40","18201.99"
"1276","TCCL1002 - KUMAR CABLE NETWORK ( TNTDNTCCL1002 ) ","2023-11-20 11:35:28","DDL1749477878","Deduction","C2149806","","84.61","18117.38"
"1277","TCCL1002 - KUMAR CABLE NETWORK ( TNTDNTCCL1002 ) ","2023-11-20 11:35:28","DDL1749477893","Deduction","C1427055","","35.40","18081.98"
"1278","TCCL1002 - KUMAR CABLE NETWORK ( TNTDNTCCL1002 ) ","2023-11-20 11:35:28","DDL1749477898","Deduction","C1427055","","84.61","17997.37"
"1279","TCCL1002 - KUMAR CABLE NETWORK ( TNTDNTCCL1002 ) ","2023-11-20 11:35:29","DDL1749477913","Deduction","C6351898","","35.40","17961.97"
"1280","TCCL1002 - KUMAR CABLE NETWORK ( TNTDNTCCL1002 ) ","2023-11-20 11:35:29","DDL1749477918","Deduction","C6351898","","84.61","17877.36"
"1281","TCCL1002 - KUMAR CABLE NETWORK ( TNTDNTCCL1002 ) ","2023-11-20 11:35:29","DDL1749477938","Deduction","C12213465","","35.40","17841.96"
"1282","TCCL1002 - KUMAR CABLE NETWORK ( TNTDNTCCL1002 ) ","2023-11-20 11:35:29","DDL1749477943","Deduction","C12213465","","84.61","17757.35"
"1283","TCCL1002 - KUMAR CABLE NETWORK ( TNTDNTCCL1002 ) ","2023-11-20 11:35:29","DDL1749477958","Deduction","C1427641","","35.40","17721.95"
"1284","TCCL1002 - KUMAR CABLE NETWORK ( TNTDNTCCL1002 ) ","2023-11-20 11:35:29","DDL1749477968","Deduction","C1427641","","84.61","17637.34"
"1285","TCCL1002 - KUMAR CABLE NETWORK ( TNTDNTCCL1002 ) ","2023-11-20 11:35:29","DDL1749477983","Deduction","C1432090","","35.40","17601.94"
"1286","TCCL1002 - KUMAR CABLE NETWORK ( TNTDNTCCL1002 ) ","2023-11-20 11:35:29","DDL1749477988","Deduction","C1432090","","84.61","17517.33"
"1287","TCCL1002 - KUMAR CABLE NETWORK ( TNTDNTCCL1002 ) ","2023-11-20 11:35:29","DDL1749477998","Deduction","C1244143","","35.40","17481.93"
"1288","TCCL1002 - KUMAR CABLE NETWORK ( TNTDNTCCL1002 ) ","2023-11-20 11:35:29","DDL1749478003","Deduction","C1244143","","84.61","17397.32"
"1289","TCCL1002 - KUMAR CABLE NETWORK ( TNTDNTCCL1002 ) ","2023-11-20 11:35:29","DDL1749478018","Deduction","C4073642","","35.40","17361.92"
"1290","TCCL1002 - KUMAR CABLE NETWORK ( TNTDNTCCL1002 ) ","2023-11-20 11:35:29","DDL1749478023","Deduction","C4073642","","84.61","17277.31"
"1291","TCCL1002 - KUMAR CABLE NETWORK ( TNTDNTCCL1002 ) ","2023-11-20 11:35:29","DDL1749478028","Deduction","C4300560","","35.40","17241.91"
"1292","TCCL1002 - KUMAR CABLE NETWORK ( TNTDNTCCL1002 ) ","2023-11-20 11:35:29","DDL1749478033","Deduction","C4300560","","84.61","17157.3"
"1293","TCCL1002 - KUMAR CABLE NETWORK ( TNTDNTCCL1002 ) ","2023-11-20 11:35:29","DDL1749478043","Deduction","C3875743","","35.40","17121.9"
"1294","TCCL1002 - KUMAR CABLE NETWORK ( TNTDNTCCL1002 ) ","2023-11-20 11:35:29","DDL1749478048","Deduction","C3875743","","84.61","17037.29"
"1295","TCCL1002 - KUMAR CABLE NETWORK ( TNTDNTCCL1002 ) ","2023-11-20 11:35:29","DDL1749478058","Deduction","C1459352","","35.40","17001.89"
"1296","TCCL1002 - KUMAR CABLE NETWORK ( TNTDNTCCL1002 ) ","2023-11-20 11:35:29","DDL1749478063","Deduction","C1459352","","84.61","16917.28"
"1297","TCCL1002 - KUMAR CABLE NETWORK ( TNTDNTCCL1002 ) ","2023-11-20 11:35:29","DDL1749478093","Deduction","C4300548","","35.40","16881.88"
"1298","TCCL1002 - KUMAR CABLE NETWORK ( TNTDNTCCL1002 ) ","2023-11-20 11:35:29","DDL1749478098","Deduction","C4300548","","84.61","16797.27"
"1299","TCCL1002 - KUMAR CABLE NETWORK ( TNTDNTCCL1002 ) ","2023-11-20 11:35:29","DDL1749478103","Deduction","C0769247","","35.40","16761.87"
"1300","TCCL1002 - KUMAR CABLE NETWORK ( TNTDNTCCL1002 ) ","2023-11-20 11:35:29","DDL1749478108","Deduction","C0769247","","84.61","16677.26"
"1301","TCCL1002 - KUMAR CABLE NETWORK ( TNTDNTCCL1002 ) ","2023-11-20 11:35:29","DDL1749478113","Deduction","C0756488","","35.40","16641.86"
"1302","TCCL1002 - KUMAR CABLE NETWORK ( TNTDNTCCL1002 ) ","2023-11-20 11:35:29","DDL1749478118","Deduction","C0756488","","84.61","16557.25"
"1303","TCCL1002 - KUMAR CABLE NETWORK ( TNTDNTCCL1002 ) ","2023-11-20 11:35:29","DDL1749478128","Deduction","C3342594","","35.40","16521.85"
"1304","TCCL1002 - KUMAR CABLE NETWORK ( TNTDNTCCL1002 ) ","2023-11-20 11:35:29","DDL1749478133","Deduction","C3342594","","84.61","16437.24"
"1305","TCCL1002 - KUMAR CABLE NETWORK ( TNTDNTCCL1002 ) ","2023-11-20 11:35:29","DDL1749478138","Deduction","C1437360","","35.40","16401.84"
"1306","TCCL1002 - KUMAR CABLE NETWORK ( TNTDNTCCL1002 ) ","2023-11-20 11:35:29","DDL1749478143","Deduction","C1437360","","84.61","16317.23"
"1307","TCCL1002 - KUMAR CABLE NETWORK ( TNTDNTCCL1002 ) ","2023-11-20 11:35:29","DDL1749478153","Deduction","C2334438","","35.40","16281.83"
"1308","TCCL1002 - KUMAR CABLE NETWORK ( TNTDNTCCL1002 ) ","2023-11-20 11:35:29","DDL1749478158","Deduction","C2334438","","84.61","16197.22"
"1309","TCCL1002 - KUMAR CABLE NETWORK ( TNTDNTCCL1002 ) ","2023-11-20 11:35:30","DDL1749478173","Deduction","C0769358","","35.40","16161.82"
"1310","TCCL1002 - KUMAR CABLE NETWORK ( TNTDNTCCL1002 ) ","2023-11-20 11:35:30","DDL1749478178","Deduction","C0769358","","84.61","16077.21"
"1311","TCCL1002 - KUMAR CABLE NETWORK ( TNTDNTCCL1002 ) ","2023-11-20 11:35:30","DDL1749478213","Deduction","C7832592","","35.40","16041.81"
"1312","TCCL1002 - KUMAR CABLE NETWORK ( TNTDNTCCL1002 ) ","2023-11-20 11:35:30","DDL1749478218","Deduction","C7832592","","84.61","15957.2"
"1313","TCCL1002 - KUMAR CABLE NETWORK ( TNTDNTCCL1002 ) ","2023-11-20 11:35:30","DDL1749478273","Deduction","C4184972","","35.40","15921.8"
"1314","TCCL1002 - KUMAR CABLE NETWORK ( TNTDNTCCL1002 ) ","2023-11-20 11:35:30","DDL1749478278","Deduction","C4184972","","84.61","15837.19"
"1315","TCCL1002 - KUMAR CABLE NETWORK ( TNTDNTCCL1002 ) ","2023-11-20 11:35:30","DDL1749478283","Deduction","C6144382","","35.40","15801.79"
"1316","TCCL1002 - KUMAR CABLE NETWORK ( TNTDNTCCL1002 ) ","2023-11-20 11:35:30","DDL1749478288","Deduction","C6144382","","84.61","15717.18"
"1317","TCCL1002 - KUMAR CABLE NETWORK ( TNTDNTCCL1002 ) ","2023-11-20 11:35:30","DDL1749478298","Deduction","C1693301","","35.40","15681.78"
"1318","TCCL1002 - KUMAR CABLE NETWORK ( TNTDNTCCL1002 ) ","2023-11-20 11:35:30","DDL1749478303","Deduction","C1693301","","124.60","15557.18"
"1319","TCCL1002 - KUMAR CABLE NETWORK ( TNTDNTCCL1002 ) ","2023-11-20 11:35:30","DDL1749478313","Deduction","C2120530","","35.40","15521.78"
"1320","TCCL1002 - KUMAR CABLE NETWORK ( TNTDNTCCL1002 ) ","2023-11-20 11:35:30","DDL1749478318","Deduction","C2120530","","84.61","15437.17"
"1321","TCCL1002 - KUMAR CABLE NETWORK ( TNTDNTCCL1002 ) ","2023-11-20 11:35:30","DDL1749478328","Deduction","C1427006","","35.40","15401.77"
"1322","TCCL1002 - KUMAR CABLE NETWORK ( TNTDNTCCL1002 ) ","2023-11-20 11:35:30","DDL1749478333","Deduction","C1427006","","84.61","15317.16"
"1323","TCCL1002 - KUMAR CABLE NETWORK ( TNTDNTCCL1002 ) ","2023-11-20 11:35:30","DDL1749478353","Deduction","C5076832","","35.40","15281.76"
"1324","TCCL1002 - KUMAR CABLE NETWORK ( TNTDNTCCL1002 ) ","2023-11-20 11:35:30","DDL1749478358","Deduction","C5076832","","84.61","15197.15"
"1325","TCCL1002 - KUMAR CABLE NETWORK ( TNTDNTCCL1002 ) ","2023-11-20 11:35:30","DDL1749478368","Deduction","C1554617","","35.40","15161.75"
"1326","TCCL1002 - KUMAR CABLE NETWORK ( TNTDNTCCL1002 ) ","2023-11-20 11:35:30","DDL1749478373","Deduction","C1554617","","84.61","15077.14"
"1327","TCCL1002 - KUMAR CABLE NETWORK ( TNTDNTCCL1002 ) ","2023-11-20 11:35:30","DDL1749478383","Deduction","C1554069","","35.40","15041.74"
"1328","TCCL1002 - KUMAR CABLE NETWORK ( TNTDNTCCL1002 ) ","2023-11-20 11:35:30","DDL1749478388","Deduction","C1554069","","84.61","14957.13"
"1329","TCCL1002 - KUMAR CABLE NETWORK ( TNTDNTCCL1002 ) ","2023-11-20 11:35:30","DDL1749478398","Deduction","C1010021","","35.40","14921.73"
"1330","TCCL1002 - KUMAR CABLE NETWORK ( TNTDNTCCL1002 ) ","2023-11-20 11:35:30","DDL1749478403","Deduction","C1010021","","84.61","14837.12"
"1331","TCCL1002 - KUMAR CABLE NETWORK ( TNTDNTCCL1002 ) ","2023-11-20 11:35:30","DDL1749478423","Deduction","C11942814","","35.40","14801.72"
"1332","TCCL1002 - KUMAR CABLE NETWORK ( TNTDNTCCL1002 ) ","2023-11-20 11:35:30","DDL1749478428","Deduction","C11942814","","84.61","14717.11"
"1333","TCCL1002 - KUMAR CABLE NETWORK ( TNTDNTCCL1002 ) ","2023-11-20 11:35:30","DDL1749478438","Deduction","C2266442","","35.40","14681.71"
"1334","TCCL1002 - KUMAR CABLE NETWORK ( TNTDNTCCL1002 ) ","2023-11-20 11:35:30","DDL1749478443","Deduction","C2266442","","84.61","14597.1"
"1335","TCCL1002 - KUMAR CABLE NETWORK ( TNTDNTCCL1002 ) ","2023-11-20 11:35:30","DDL1749478463","Deduction","C5146791","","35.40","14561.7"
"1336","TCCL1002 - KUMAR CABLE NETWORK ( TNTDNTCCL1002 ) ","2023-11-20 11:35:30","DDL1749478473","Deduction","C5146791","","84.61","14477.09"
"1337","TCCL1002 - KUMAR CABLE NETWORK ( TNTDNTCCL1002 ) ","2023-11-20 11:35:30","DDL1749478493","Deduction","C8719391","","35.40","14441.69"
"1338","TCCL1002 - KUMAR CABLE NETWORK ( TNTDNTCCL1002 ) ","2023-11-20 11:35:30","DDL1749478498","Deduction","C8719391","","84.61","14357.08"
"1339","TCCL1002 - KUMAR CABLE NETWORK ( TNTDNTCCL1002 ) ","2023-11-20 11:35:31","DDL1749478508","Deduction","C1676819","","35.40","14321.68"
"1340","TCCL1002 - KUMAR CABLE NETWORK ( TNTDNTCCL1002 ) ","2023-11-20 11:35:31","DDL1749478513","Deduction","C1676819","","84.61","14237.07"
"1341","TCCL1002 - KUMAR CABLE NETWORK ( TNTDNTCCL1002 ) ","2023-11-20 11:35:31","DDL1749478528","Deduction","C1459282","","35.40","14201.67"
"1342","TCCL1002 - KUMAR CABLE NETWORK ( TNTDNTCCL1002 ) ","2023-11-20 11:35:31","DDL1749478533","Deduction","C1459282","","84.61","14117.06"
"1343","TCCL1002 - KUMAR CABLE NETWORK ( TNTDNTCCL1002 ) ","2023-11-20 11:35:31","DDL1749478548","Deduction","C1291192","","35.40","14081.66"
"1344","TCCL1002 - KUMAR CABLE NETWORK ( TNTDNTCCL1002 ) ","2023-11-20 11:35:31","DDL1749478553","Deduction","C1291192","","84.61","13997.05"
"1345","TCCL1002 - KUMAR CABLE NETWORK ( TNTDNTCCL1002 ) ","2023-11-20 11:35:31","DDL1749478573","Deduction","C4300557","","35.40","13961.65"
"1346","TCCL1002 - KUMAR CABLE NETWORK ( TNTDNTCCL1002 ) ","2023-11-20 11:35:31","DDL1749478578","Deduction","C4300557","","84.61","13877.04"
"1347","TCCL1002 - KUMAR CABLE NETWORK ( TNTDNTCCL1002 ) ","2023-11-20 11:35:31","DDL1749478583","Deduction","C6725457","","35.40","13841.64"
"1348","TCCL1002 - KUMAR CABLE NETWORK ( TNTDNTCCL1002 ) ","2023-11-20 11:35:31","DDL1749478588","Deduction","C6725457","","84.61","13757.03"
"1349","TCCL1002 - KUMAR CABLE NETWORK ( TNTDNTCCL1002 ) ","2023-11-20 11:35:31","DDL1749478598","Deduction","C1468096","","35.40","13721.63"
"1350","TCCL1002 - KUMAR CABLE NETWORK ( TNTDNTCCL1002 ) ","2023-11-20 11:35:31","DDL1749478603","Deduction","C1468096","","84.61","13637.02"
"1351","TCCL1002 - KUMAR CABLE NETWORK ( TNTDNTCCL1002 ) ","2023-11-20 11:35:31","DDL1749478613","Deduction","C3341959","","35.40","13601.62"
"1352","TCCL1002 - KUMAR CABLE NETWORK ( TNTDNTCCL1002 ) ","2023-11-20 11:35:31","DDL1749478618","Deduction","C3341959","","84.61","13517.01"
"1353","TCCL1002 - KUMAR CABLE NETWORK ( TNTDNTCCL1002 ) ","2023-11-20 11:35:31","DDL1749478628","Deduction","C4083997","","35.40","13481.61"
"1354","TCCL1002 - KUMAR CABLE NETWORK ( TNTDNTCCL1002 ) ","2023-11-20 11:35:31","DDL1749478633","Deduction","C4083997","","84.61","13397"
"1355","TCCL1002 - KUMAR CABLE NETWORK ( TNTDNTCCL1002 ) ","2023-11-20 11:35:31","DDL1749478643","Deduction","C3066959","","35.40","13361.6"
"1356","TCCL1002 - KUMAR CABLE NETWORK ( TNTDNTCCL1002 ) ","2023-11-20 11:35:31","DDL1749478648","Deduction","C3066959","","124.60","13237"
"1357","TCCL1002 - KUMAR CABLE NETWORK ( TNTDNTCCL1002 ) ","2023-11-20 11:35:31","DDL1749478673","Deduction","C1448873","","35.40","13201.6"
"1358","TCCL1002 - KUMAR CABLE NETWORK ( TNTDNTCCL1002 ) ","2023-11-20 11:35:31","DDL1749478678","Deduction","C1448873","","84.61","13116.99"
"1359","TCCL1002 - KUMAR CABLE NETWORK ( TNTDNTCCL1002 ) ","2023-11-20 11:35:31","DDL1749478683","Deduction","C2112697","","35.40","13081.59"
"1360","TCCL1002 - KUMAR CABLE NETWORK ( TNTDNTCCL1002 ) ","2023-11-20 11:35:31","DDL1749478688","Deduction","C2112697","","84.61","12996.98"
"1361","TCCL1002 - KUMAR CABLE NETWORK ( TNTDNTCCL1002 ) ","2023-11-20 11:35:31","DDL1749478693","Deduction","C8151612","","35.40","12961.58"
"1362","TCCL1002 - KUMAR CABLE NETWORK ( TNTDNTCCL1002 ) ","2023-11-20 11:35:31","DDL1749478698","Deduction","C8151612","","84.61","12876.97"
"1363","TCCL1002 - KUMAR CABLE NETWORK ( TNTDNTCCL1002 ) ","2023-11-20 11:35:31","DDL1749478713","Deduction","C2361951","","35.40","12841.57"
"1364","TCCL1002 - KUMAR CABLE NETWORK ( TNTDNTCCL1002 ) ","2023-11-20 11:35:31","DDL1749478718","Deduction","C2361951","","84.61","12756.96"
"1365","TCCL1002 - KUMAR CABLE NETWORK ( TNTDNTCCL1002 ) ","2023-11-20 11:35:31","DDL1749478748","Deduction","C1554616","","35.40","12721.56"
"1366","TCCL1002 - KUMAR CABLE NETWORK ( TNTDNTCCL1002 ) ","2023-11-20 11:35:31","DDL1749478753","Deduction","C1554616","","84.61","12636.95"
"1367","TCCL1002 - KUMAR CABLE NETWORK ( TNTDNTCCL1002 ) ","2023-11-20 11:35:32","DDL1749478788","Deduction","C1449005","","35.40","12601.55"
"1368","TCCL1002 - KUMAR CABLE NETWORK ( TNTDNTCCL1002 ) ","2023-11-20 11:35:32","DDL1749478793","Deduction","C1449005","","84.61","12516.94"
"1369","TCCL1002 - KUMAR CABLE NETWORK ( TNTDNTCCL1002 ) ","2023-11-20 11:35:32","DDL1749478808","Deduction","C7419138","","35.40","12481.54"
"1370","TCCL1002 - KUMAR CABLE NETWORK ( TNTDNTCCL1002 ) ","2023-11-20 11:35:32","DDL1749478813","Deduction","C7419138","","84.61","12396.93"
"1371","TCCL1002 - KUMAR CABLE NETWORK ( TNTDNTCCL1002 ) ","2023-11-20 11:35:32","DDL1749478843","Deduction","C7346395","","35.40","12361.53"
"1372","TCCL1002 - KUMAR CABLE NETWORK ( TNTDNTCCL1002 ) ","2023-11-20 11:35:32","DDL1749478853","Deduction","C7346395","","84.61","12276.92"
"1373","TCCL1002 - KUMAR CABLE NETWORK ( TNTDNTCCL1002 ) ","2023-11-20 11:35:32","DDL1749478863","Deduction","C9246684","","35.40","12241.52"
"1374","TCCL1002 - KUMAR CABLE NETWORK ( TNTDNTCCL1002 ) ","2023-11-20 11:35:32","DDL1749478868","Deduction","C9246684","","84.61","12156.91"
"1375","TCCL1002 - KUMAR CABLE NETWORK ( TNTDNTCCL1002 ) ","2023-11-20 11:35:32","DDL1749478883","Deduction","C2051430","","35.40","12121.51"
"1376","TCCL1002 - KUMAR CABLE NETWORK ( TNTDNTCCL1002 ) ","2023-11-20 11:35:32","DDL1749478888","Deduction","C2051430","","84.61","12036.9"
"1377","TCCL1002 - KUMAR CABLE NETWORK ( TNTDNTCCL1002 ) ","2023-11-20 11:35:32","DDL1749478908","Deduction","C1495997","","35.40","12001.5"
"1378","TCCL1002 - KUMAR CABLE NETWORK ( TNTDNTCCL1002 ) ","2023-11-20 11:35:32","DDL1749478913","Deduction","C1495997","","84.61","11916.89"
"1379","TCCL1002 - KUMAR CABLE NETWORK ( TNTDNTCCL1002 ) ","2023-11-20 11:35:32","DDL1749478918","Deduction","C0912432","","35.40","11881.49"
"1380","TCCL1002 - KUMAR CABLE NETWORK ( TNTDNTCCL1002 ) ","2023-11-20 11:35:32","DDL1749478928","Deduction","C0912432","","84.61","11796.88"
"1381","TCCL1002 - KUMAR CABLE NETWORK ( TNTDNTCCL1002 ) ","2023-11-20 11:35:32","DDL1749478948","Deduction","C12335179","","35.40","11761.48"
"1382","TCCL1002 - KUMAR CABLE NETWORK ( TNTDNTCCL1002 ) ","2023-11-20 11:35:32","DDL1749478953","Deduction","C12335179","","84.61","11676.87"
"1383","TCCL1002 - KUMAR CABLE NETWORK ( TNTDNTCCL1002 ) ","2023-11-20 11:35:32","DDL1749478983","Deduction","C2253859","","35.40","11641.47"
"1384","TCCL1002 - KUMAR CABLE NETWORK ( TNTDNTCCL1002 ) ","2023-11-20 11:35:32","DDL1749478988","Deduction","C2253859","","84.61","11556.86"
"1385","TCCL1002 - KUMAR CABLE NETWORK ( TNTDNTCCL1002 ) ","2023-11-20 11:35:32","DDL1749479003","Deduction","C3913039","","35.40","11521.46"
"1386","TCCL1002 - KUMAR CABLE NETWORK ( TNTDNTCCL1002 ) ","2023-11-20 11:35:32","DDL1749479008","Deduction","C3913039","","84.61","11436.85"
"1387","TCCL1002 - KUMAR CABLE NETWORK ( TNTDNTCCL1002 ) ","2023-11-20 11:35:32","DDL1749479013","Deduction","C1427096","","35.40","11401.45"
"1388","TCCL1002 - KUMAR CABLE NETWORK ( TNTDNTCCL1002 ) ","2023-11-20 11:35:32","DDL1749479018","Deduction","C1427096","","84.61","11316.84"
"1389","TCCL1002 - KUMAR CABLE NETWORK ( TNTDNTCCL1002 ) ","2023-11-20 11:35:32","DDL1749479033","Deduction","C1291197","","35.40","11281.44"
"1390","TCCL1002 - KUMAR CABLE NETWORK ( TNTDNTCCL1002 ) ","2023-11-20 11:35:32","DDL1749479038","Deduction","C1291197","","84.61","11196.83"
"1391","TCCL1002 - KUMAR CABLE NETWORK ( TNTDNTCCL1002 ) ","2023-11-20 11:35:32","DDL1749479053","Deduction","C1101626","","35.40","11161.43"
"1392","TCCL1002 - KUMAR CABLE NETWORK ( TNTDNTCCL1002 ) ","2023-11-20 11:35:32","DDL1749479058","Deduction","C1101626","","84.61","11076.82"
"1393","TCCL1002 - KUMAR CABLE NETWORK ( TNTDNTCCL1002 ) ","2023-11-20 11:35:33","DDL1749479068","Deduction","C1426504","","35.40","11041.42"
"1394","TCCL1002 - KUMAR CABLE NETWORK ( TNTDNTCCL1002 ) ","2023-11-20 11:35:33","DDL1749479078","Deduction","C1426504","","84.61","10956.81"
"1395","TCCL1002 - KUMAR CABLE NETWORK ( TNTDNTCCL1002 ) ","2023-11-20 11:35:33","DDL1749479088","Deduction","C0798159","","35.40","10921.41"
"1396","TCCL1002 - KUMAR CABLE NETWORK ( TNTDNTCCL1002 ) ","2023-11-20 11:35:33","DDL1749479093","Deduction","C0798159","","84.61","10836.8"
"1397","TCCL1002 - KUMAR CABLE NETWORK ( TNTDNTCCL1002 ) ","2023-11-20 11:35:33","DDL1749479108","Deduction","C2558743","","35.40","10801.4"
"1398","TCCL1002 - KUMAR CABLE NETWORK ( TNTDNTCCL1002 ) ","2023-11-20 11:35:33","DDL1749479113","Deduction","C2558743","","84.61","10716.79"
"1399","TCCL1002 - KUMAR CABLE NETWORK ( TNTDNTCCL1002 ) ","2023-11-20 11:35:33","DDL1749479118","Deduction","C5143534","","35.40","10681.39"
"1400","TCCL1002 - KUMAR CABLE NETWORK ( TNTDNTCCL1002 ) ","2023-11-20 11:35:33","DDL1749479123","Deduction","C5143534","","84.61","10596.78"
"1401","TCCL1002 - KUMAR CABLE NETWORK ( TNTDNTCCL1002 ) ","2023-11-20 11:35:33","DDL1749479128","Deduction","C1554067","","35.40","10561.38"
"1402","TCCL1002 - KUMAR CABLE NETWORK ( TNTDNTCCL1002 ) ","2023-11-20 11:35:33","DDL1749479133","Deduction","C1554067","","84.61","10476.77"
"1403","TCCL1002 - KUMAR CABLE NETWORK ( TNTDNTCCL1002 ) ","2023-11-20 11:35:33","DDL1749479138","Deduction","C0912367","","35.40","10441.37"
"1404","TCCL1002 - KUMAR CABLE NETWORK ( TNTDNTCCL1002 ) ","2023-11-20 11:35:33","DDL1749479143","Deduction","C0912367","","84.61","10356.76"
"1405","TCCL1002 - KUMAR CABLE NETWORK ( TNTDNTCCL1002 ) ","2023-11-20 11:35:33","DDL1749479148","Deduction","C4810648","","35.40","10321.36"
"1406","TCCL1002 - KUMAR CABLE NETWORK ( TNTDNTCCL1002 ) ","2023-11-20 11:35:33","DDL1749479153","Deduction","C4810648","","84.61","10236.75"
"1407","TCCL1002 - KUMAR CABLE NETWORK ( TNTDNTCCL1002 ) ","2023-11-20 11:35:33","DDL1749479158","Deduction","C10956878","","35.40","10201.35"
"1408","TCCL1002 - KUMAR CABLE NETWORK ( TNTDNTCCL1002 ) ","2023-11-20 11:35:33","DDL1749479168","Deduction","C10956878","","84.61","10116.74"
"1409","TCCL1002 - KUMAR CABLE NETWORK ( TNTDNTCCL1002 ) ","2023-11-20 11:35:33","DDL1749479173","Deduction","C1554611","","35.40","10081.34"
"1410","TCCL1002 - KUMAR CABLE NETWORK ( TNTDNTCCL1002 ) ","2023-11-20 11:35:33","DDL1749479178","Deduction","C1554611","","84.61","9996.73"
"1411","TCCL1002 - KUMAR CABLE NETWORK ( TNTDNTCCL1002 ) ","2023-11-20 11:35:33","DDL1749479198","Deduction","C1432096","","35.40","9961.33"
"1412","TCCL1002 - KUMAR CABLE NETWORK ( TNTDNTCCL1002 ) ","2023-11-20 11:35:33","DDL1749479203","Deduction","C1432096","","84.61","9876.72"
"1413","TCCL1002 - KUMAR CABLE NETWORK ( TNTDNTCCL1002 ) ","2023-11-20 11:35:33","DDL1749479223","Deduction","C1437289","","35.40","9841.32"
"1414","TCCL1002 - KUMAR CABLE NETWORK ( TNTDNTCCL1002 ) ","2023-11-20 11:35:33","DDL1749479228","Deduction","C1437289","","84.61","9756.71"
"1415","TCCL1002 - KUMAR CABLE NETWORK ( TNTDNTCCL1002 ) ","2023-11-20 11:35:33","DDL1749479238","Deduction","C0777090","","35.40","9721.31"
"1416","TCCL1002 - KUMAR CABLE NETWORK ( TNTDNTCCL1002 ) ","2023-11-20 11:35:33","DDL1749479243","Deduction","C0777090","","84.61","9636.7"
"1417","TCCL1002 - KUMAR CABLE NETWORK ( TNTDNTCCL1002 ) ","2023-11-20 11:35:33","DDL1749479263","Deduction","C1437320","","35.40","9601.3"
"1418","TCCL1002 - KUMAR CABLE NETWORK ( TNTDNTCCL1002 ) ","2023-11-20 11:35:33","DDL1749479268","Deduction","C1437320","","84.61","9516.69"
"1419","TCCL1002 - KUMAR CABLE NETWORK ( TNTDNTCCL1002 ) ","2023-11-20 11:35:33","DDL1749479278","Deduction","C1425806","","35.40","9481.29"
"1420","TCCL1002 - KUMAR CABLE NETWORK ( TNTDNTCCL1002 ) ","2023-11-20 11:35:33","DDL1749479283","Deduction","C1425806","","84.61","9396.68"
"1421","TCCL1002 - KUMAR CABLE NETWORK ( TNTDNTCCL1002 ) ","2023-11-20 11:35:33","DDL1749479293","Deduction","C0756480","","35.40","9361.28"
"1422","TCCL1002 - KUMAR CABLE NETWORK ( TNTDNTCCL1002 ) ","2023-11-20 11:35:33","DDL1749479303","Deduction","C0756480","","84.61","9276.67"
"1423","TCCL1002 - KUMAR CABLE NETWORK ( TNTDNTCCL1002 ) ","2023-11-20 11:35:34","DDL1749479318","Deduction","C0839779","","35.40","9241.27"
"1424","TCCL1002 - KUMAR CABLE NETWORK ( TNTDNTCCL1002 ) ","2023-11-20 11:35:34","DDL1749479323","Deduction","C0839779","","84.61","9156.66"
"1425","TCCL1002 - KUMAR CABLE NETWORK ( TNTDNTCCL1002 ) ","2023-11-20 11:35:34","DDL1749479343","Deduction","C1449004","","35.40","9121.26"
"1426","TCCL1002 - KUMAR CABLE NETWORK ( TNTDNTCCL1002 ) ","2023-11-20 11:35:34","DDL1749479348","Deduction","C1449004","","84.61","9036.65"
"1427","TCCL1002 - KUMAR CABLE NETWORK ( TNTDNTCCL1002 ) ","2023-11-20 11:35:34","DDL1749479388","Deduction","C2266457","","7.08","9029.57"
"1428","TCCL1002 - KUMAR CABLE NETWORK ( TNTDNTCCL1002 ) ","2023-11-20 11:35:34","DDL1749479393","Deduction","C2266457","","16.92","9012.65"
"1429","TCCL1002 - KUMAR CABLE NETWORK ( TNTDNTCCL1002 ) ","2023-11-20 11:35:34","DDL1749479443","Deduction","C2266457","","12.98","8999.67"
"1430","TCCL1002 - KUMAR CABLE NETWORK ( TNTDNTCCL1002 ) ","2023-11-20 11:35:34","DDL1749479458","Deduction","C2266457","","31.03","8968.64"
"1431","TCCL1002 - KUMAR CABLE NETWORK ( TNTDNTCCL1002 ) ","2023-11-20 11:35:34","DDL1749479463","Deduction","C5527136","","35.40","8933.24"
"1432","TCCL1002 - KUMAR CABLE NETWORK ( TNTDNTCCL1002 ) ","2023-11-20 11:35:34","DDL1749479468","Deduction","C5527136","","84.61","8848.63"
"1433","TCCL1002 - KUMAR CABLE NETWORK ( TNTDNTCCL1002 ) ","2023-11-20 11:35:35","DDL1749479473","Deduction","C1267818","","35.40","8813.23"
"1434","TCCL1002 - KUMAR CABLE NETWORK ( TNTDNTCCL1002 ) ","2023-11-20 11:35:35","DDL1749479478","Deduction","C1267818","","84.61","8728.62"
"1435","TCCL1002 - KUMAR CABLE NETWORK ( TNTDNTCCL1002 ) ","2023-11-20 11:35:35","DDL1749479483","Deduction","C10349797","","35.40","8693.22"
"1436","TCCL1002 - KUMAR CABLE NETWORK ( TNTDNTCCL1002 ) ","2023-11-20 11:35:35","DDL1749479488","Deduction","C10349797","","84.61","8608.61"
"1437","TCCL1002 - KUMAR CABLE NETWORK ( TNTDNTCCL1002 ) ","2023-11-20 11:35:35","DDL1749479493","Deduction","C0797263","","35.40","8573.21"
"1438","TCCL1002 - KUMAR CABLE NETWORK ( TNTDNTCCL1002 ) ","2023-11-20 11:35:35","DDL1749479498","Deduction","C0797263","","84.61","8488.6"
"1439","TCCL1002 - KUMAR CABLE NETWORK ( TNTDNTCCL1002 ) ","2023-11-20 11:35:35","DDL1749479503","Deduction","C5271559","","35.40","8453.2"
"1440","TCCL1002 - KUMAR CABLE NETWORK ( TNTDNTCCL1002 ) ","2023-11-20 11:35:35","DDL1749479508","Deduction","C5271559","","84.61","8368.59"
"1441","TCCL1002 - KUMAR CABLE NETWORK ( TNTDNTCCL1002 ) ","2023-11-20 11:35:35","DDL1749479513","Deduction","C0839942","","35.40","8333.19"
"1442","TCCL1002 - KUMAR CABLE NETWORK ( TNTDNTCCL1002 ) ","2023-11-20 11:35:35","DDL1749479518","Deduction","C0839942","","84.61","8248.58"
"1443","TCCL1002 - KUMAR CABLE NETWORK ( TNTDNTCCL1002 ) ","2023-11-20 11:35:35","DDL1749479528","Deduction","C0839767","","35.40","8213.18"
"1444","TCCL1002 - KUMAR CABLE NETWORK ( TNTDNTCCL1002 ) ","2023-11-20 11:35:35","DDL1749479533","Deduction","C0839767","","84.61","8128.57"
"1445","TCCL1002 - KUMAR CABLE NETWORK ( TNTDNTCCL1002 ) ","2023-11-20 11:35:35","DDL1749479538","Deduction","C2957470","","35.40","8093.17"
"1446","TCCL1002 - KUMAR CABLE NETWORK ( TNTDNTCCL1002 ) ","2023-11-20 11:35:35","DDL1749479543","Deduction","C2957470","","84.61","8008.56"
"1447","TCCL1002 - KUMAR CABLE NETWORK ( TNTDNTCCL1002 ) ","2023-11-20 11:35:35","DDL1749479548","Deduction","C6843192","","35.40","7973.16"
"1448","TCCL1002 - KUMAR CABLE NETWORK ( TNTDNTCCL1002 ) ","2023-11-20 11:35:35","DDL1749479553","Deduction","C6843192","","84.61","7888.55"
"1449","TCCL1002 - KUMAR CABLE NETWORK ( TNTDNTCCL1002 ) ","2023-11-20 11:35:35","DDL1749479563","Deduction","C2311055","","35.40","7853.15"
"1450","TCCL1002 - KUMAR CABLE NETWORK ( TNTDNTCCL1002 ) ","2023-11-20 11:35:35","DDL1749479568","Deduction","C2311055","","47.78","7805.37"
"1451","TCCL1002 - KUMAR CABLE NETWORK ( TNTDNTCCL1002 ) ","2023-11-20 11:35:35","DDL1749479573","Deduction","C1291195","","35.40","7769.97"
"1452","TCCL1002 - KUMAR CABLE NETWORK ( TNTDNTCCL1002 ) ","2023-11-20 11:35:35","DDL1749479578","Deduction","C1291195","","84.61","7685.36"
"1453","TCCL1002 - KUMAR CABLE NETWORK ( TNTDNTCCL1002 ) ","2023-11-20 11:35:35","DDL1749479583","Deduction","C0839950","","35.40","7649.96"
"1454","TCCL1002 - KUMAR CABLE NETWORK ( TNTDNTCCL1002 ) ","2023-11-20 11:35:35","DDL1749479588","Deduction","C0839950","","84.61","7565.35"
"1455","TCCL1002 - KUMAR CABLE NETWORK ( TNTDNTCCL1002 ) ","2023-11-20 11:35:35","DDL1749479593","Deduction","C2103869","","35.40","7529.95"
"1456","TCCL1002 - KUMAR CABLE NETWORK ( TNTDNTCCL1002 ) ","2023-11-20 11:35:35","DDL1749479598","Deduction","C2103869","","84.61","7445.34"
"1457","TCCL1002 - KUMAR CABLE NETWORK ( TNTDNTCCL1002 ) ","2023-11-20 11:35:35","DDL1749479603","Deduction","C6096709","","35.40","7409.94"
"1458","TCCL1002 - KUMAR CABLE NETWORK ( TNTDNTCCL1002 ) ","2023-11-20 11:35:35","DDL1749479608","Deduction","C6096709","","84.61","7325.33"
"1459","TCCL1002 - KUMAR CABLE NETWORK ( TNTDNTCCL1002 ) ","2023-11-20 11:35:36","DDL1749479618","Deduction","C10743576","","35.40","7289.93"
"1460","TCCL1002 - KUMAR CABLE NETWORK ( TNTDNTCCL1002 ) ","2023-11-20 11:35:36","DDL1749479623","Deduction","C10743576","","84.61","7205.32"
"1461","TCCL1002 - KUMAR CABLE NETWORK ( TNTDNTCCL1002 ) ","2023-11-20 11:35:36","DDL1749479633","Deduction","C2113643","","35.40","7169.92"
"1462","TCCL1002 - KUMAR CABLE NETWORK ( TNTDNTCCL1002 ) ","2023-11-20 11:35:36","DDL1749479638","Deduction","C2113643","","84.61","7085.31"
"1463","TCCL1002 - KUMAR CABLE NETWORK ( TNTDNTCCL1002 ) ","2023-11-20 11:35:36","DDL1749479648","Deduction","C7795023","","35.40","7049.91"
"1464","TCCL1002 - KUMAR CABLE NETWORK ( TNTDNTCCL1002 ) ","2023-11-20 11:35:36","DDL1749479653","Deduction","C7795023","","84.61","6965.3"
"1465","TCCL1002 - KUMAR CABLE NETWORK ( TNTDNTCCL1002 ) ","2023-11-20 11:35:36","DDL1749479668","Deduction","C1014398","","35.40","6929.9"
"1466","TCCL1002 - KUMAR CABLE NETWORK ( TNTDNTCCL1002 ) ","2023-11-20 11:35:36","DDL1749479673","Deduction","C1014398","","164.79","6765.11"
"1467","TCCL1002 - KUMAR CABLE NETWORK ( TNTDNTCCL1002 ) ","2023-11-20 11:35:36","DDL1749479678","Deduction","C1014398","","47.78","6717.33"
"1468","TCCL1002 - KUMAR CABLE NETWORK ( TNTDNTCCL1002 ) ","2023-11-20 11:35:36","DDL1749479683","Deduction","C1014398","","6.38","6710.95"
"1469","TCCL1002 - KUMAR CABLE NETWORK ( TNTDNTCCL1002 ) ","2023-11-20 11:35:36","DDL1749479688","Deduction","C1014398","","0.11","6710.84"
"1470","TCCL1002 - KUMAR CABLE NETWORK ( TNTDNTCCL1002 ) ","2023-11-20 11:35:36","DDL1749479703","Deduction","C5092149","","35.40","6675.44"
"1471","TCCL1002 - KUMAR CABLE NETWORK ( TNTDNTCCL1002 ) ","2023-11-20 11:35:36","DDL1749479708","Deduction","C5092149","","84.61","6590.83"
"1472","TCCL1002 - KUMAR CABLE NETWORK ( TNTDNTCCL1002 ) ","2023-11-20 11:35:36","DDL1749479738","Deduction","C1495999","","35.40","6555.43"
"1473","TCCL1002 - KUMAR CABLE NETWORK ( TNTDNTCCL1002 ) ","2023-11-20 11:35:36","DDL1749479743","Deduction","C1495999","","84.61","6470.82"
"1474","TCCL1002 - KUMAR CABLE NETWORK ( TNTDNTCCL1002 ) ","2023-11-20 11:35:46","DDL1749482633","Deduction","C2551645","","35.40","6435.42"
"1475","TCCL1002 - KUMAR CABLE NETWORK ( TNTDNTCCL1002 ) ","2023-11-20 11:35:47","DDL1749482638","Deduction","C2551645","","84.61","6350.81"
"1476","TCCL1002 - KUMAR CABLE NETWORK ( TNTDNTCCL1002 ) ","2023-11-20 11:35:47","DDL1749482663","Deduction","C1425705","","35.40","6315.41"
"1477","TCCL1002 - KUMAR CABLE NETWORK ( TNTDNTCCL1002 ) ","2023-11-20 11:35:47","DDL1749482668","Deduction","C1425705","","84.61","6230.8"
"1478","TCCL1002 - KUMAR CABLE NETWORK ( TNTDNTCCL1002 ) ","2023-11-20 11:35:47","DDL1749482688","Deduction","C1468098","","35.40","6195.4"
"1479","TCCL1002 - KUMAR CABLE NETWORK ( TNTDNTCCL1002 ) ","2023-11-20 11:35:47","DDL1749482693","Deduction","C1468098","","84.61","6110.79"
"1480","TCCL1002 - KUMAR CABLE NETWORK ( TNTDNTCCL1002 ) ","2023-11-20 11:35:47","DDL1749482713","Deduction","C5994050","","35.40","6075.39"
"1481","TCCL1002 - KUMAR CABLE NETWORK ( TNTDNTCCL1002 ) ","2023-11-20 11:35:47","DDL1749482718","Deduction","C5994050","","84.61","5990.78"
"1482","TCCL1002 - KUMAR CABLE NETWORK ( TNTDNTCCL1002 ) ","2023-11-20 11:35:47","DDL1749482743","Deduction","C6063433","","35.40","5955.38"
"1483","TCCL1002 - KUMAR CABLE NETWORK ( TNTDNTCCL1002 ) ","2023-11-20 11:35:47","DDL1749482748","Deduction","C6063433","","84.61","5870.77"
"1484","TCCL1002 - KUMAR CABLE NETWORK ( TNTDNTCCL1002 ) ","2023-11-20 11:35:47","DDL1749482768","Deduction","C9927995","","35.40","5835.37"
"1485","TCCL1002 - KUMAR CABLE NETWORK ( TNTDNTCCL1002 ) ","2023-11-20 11:35:47","DDL1749482773","Deduction","C9927995","","84.61","5750.76"
"1486","TCCL1002 - KUMAR CABLE NETWORK ( TNTDNTCCL1002 ) ","2023-11-20 11:35:47","DDL1749482793","Deduction","C2566372","","35.40","5715.36"
"1487","TCCL1002 - KUMAR CABLE NETWORK ( TNTDNTCCL1002 ) ","2023-11-20 11:35:47","DDL1749482798","Deduction","C2566372","","84.61","5630.75"
"1488","TCCL1002 - KUMAR CABLE NETWORK ( TNTDNTCCL1002 ) ","2023-11-20 11:35:47","DDL1749482813","Deduction","C12157796","","35.40","5595.35"
"1489","TCCL1002 - KUMAR CABLE NETWORK ( TNTDNTCCL1002 ) ","2023-11-20 11:35:47","DDL1749482818","Deduction","C12157796","","84.61","5510.74"
"1490","TCCL1002 - KUMAR CABLE NETWORK ( TNTDNTCCL1002 ) ","2023-11-20 11:35:47","DDL1749482833","Deduction","C1495995","","35.40","5475.34"
"1491","TCCL1002 - KUMAR CABLE NETWORK ( TNTDNTCCL1002 ) ","2023-11-20 11:35:47","DDL1749482838","Deduction","C1495995","","84.61","5390.73"
"1492","TCCL1002 - KUMAR CABLE NETWORK ( TNTDNTCCL1002 ) ","2023-11-20 11:35:47","DDL1749482853","Deduction","C1430868","","35.40","5355.33"
"1493","TCCL1002 - KUMAR CABLE NETWORK ( TNTDNTCCL1002 ) ","2023-11-20 11:35:47","DDL1749482858","Deduction","C1430868","","84.61","5270.72"
"1494","TCCL1002 - KUMAR CABLE NETWORK ( TNTDNTCCL1002 ) ","2023-11-20 11:35:47","DDL1749482868","Deduction","C1554614","","35.40","5235.32"
"1495","TCCL1002 - KUMAR CABLE NETWORK ( TNTDNTCCL1002 ) ","2023-11-20 11:35:47","DDL1749482873","Deduction","C1554614","","84.61","5150.71"
"1496","TCCL1002 - KUMAR CABLE NETWORK ( TNTDNTCCL1002 ) ","2023-11-20 11:35:47","DDL1749482883","Deduction","C1237951","","35.40","5115.31"
"1497","TCCL1002 - KUMAR CABLE NETWORK ( TNTDNTCCL1002 ) ","2023-11-20 11:35:47","DDL1749482888","Deduction","C1237951","","84.61","5030.7"
"1498","TCCL1002 - KUMAR CABLE NETWORK ( TNTDNTCCL1002 ) ","2023-11-20 11:35:47","DDL1749482898","Deduction","C6115333","","35.40","4995.3"
"1499","TCCL1002 - KUMAR CABLE NETWORK ( TNTDNTCCL1002 ) ","2023-11-20 11:35:47","DDL1749482903","Deduction","C6115333","","84.61","4910.69"
"1500","TCCL1002 - KUMAR CABLE NETWORK ( TNTDNTCCL1002 ) ","2023-11-20 11:35:47","DDL1749482908","Deduction","C1238016","","35.40","4875.29"
"1501","TCCL1002 - KUMAR CABLE NETWORK ( TNTDNTCCL1002 ) ","2023-11-20 11:35:47","DDL1749482913","Deduction","C1238016","","84.61","4790.68"
"1502","TCCL1002 - KUMAR CABLE NETWORK ( TNTDNTCCL1002 ) ","2023-11-20 11:35:47","DDL1749482918","Deduction","C5076993","","35.40","4755.28"
"1503","TCCL1002 - KUMAR CABLE NETWORK ( TNTDNTCCL1002 ) ","2023-11-20 11:35:47","DDL1749482923","Deduction","C5076993","","84.61","4670.67"
"1504","TCCL1002 - KUMAR CABLE NETWORK ( TNTDNTCCL1002 ) ","2023-11-20 11:35:47","DDL1749482938","Deduction","C1432094","","35.40","4635.27"
"1505","TCCL1002 - KUMAR CABLE NETWORK ( TNTDNTCCL1002 ) ","2023-11-20 11:35:48","DDL1749482943","Deduction","C1432094","","84.61","4550.66"
"1506","TCCL1002 - KUMAR CABLE NETWORK ( TNTDNTCCL1002 ) ","2023-11-20 11:35:48","DDL1749482948","Deduction","C1448871","","35.40","4515.26"
"1507","TCCL1002 - KUMAR CABLE NETWORK ( TNTDNTCCL1002 ) ","2023-11-20 11:35:48","DDL1749482953","Deduction","C1448871","","84.61","4430.65"
"1508","TCCL1002 - KUMAR CABLE NETWORK ( TNTDNTCCL1002 ) ","2023-11-20 11:35:48","DDL1749482968","Deduction","C5945921","","35.40","4395.25"
"1509","TCCL1002 - KUMAR CABLE NETWORK ( TNTDNTCCL1002 ) ","2023-11-20 11:35:48","DDL1749482973","Deduction","C5945921","","84.61","4310.64"
"1510","TCCL1002 - KUMAR CABLE NETWORK ( TNTDNTCCL1002 ) ","2023-11-20 11:35:48","DDL1749482988","Deduction","C12157930","","35.40","4275.24"
"1511","TCCL1002 - KUMAR CABLE NETWORK ( TNTDNTCCL1002 ) ","2023-11-20 11:35:48","DDL1749482993","Deduction","C12157930","","84.61","4190.63"
"1512","TCCL1002 - KUMAR CABLE NETWORK ( TNTDNTCCL1002 ) ","2023-11-20 11:35:48","DDL1749482998","Deduction","C1676810","","35.40","4155.23"
"1513","TCCL1002 - KUMAR CABLE NETWORK ( TNTDNTCCL1002 ) ","2023-11-20 11:35:48","DDL1749483003","Deduction","C1676810","","84.61","4070.62"
"1514","TCCL1002 - KUMAR CABLE NETWORK ( TNTDNTCCL1002 ) ","2023-11-20 11:35:48","DDL1749483008","Deduction","C1291194","","35.40","4035.22"
"1515","TCCL1002 - KUMAR CABLE NETWORK ( TNTDNTCCL1002 ) ","2023-11-20 11:35:48","DDL1749483013","Deduction","C1291194","","84.61","3950.61"
"1516","TCCL1002 - KUMAR CABLE NETWORK ( TNTDNTCCL1002 ) ","2023-11-20 15:04:21","DDL1750790990","Deduction","C12862375","","12.98","3937.63"
"1517","TCCL1002 - KUMAR CABLE NETWORK ( TNTDNTCCL1002 ) ","2023-11-20 15:04:21","DDL1750790995","Deduction","C12862375","","31.03","3906.6"
"1518","TCCL1002 - KUMAR CABLE NETWORK ( TNTDNTCCL1002 ) ","2023-11-25 19:24:15","DDL1765114974","Deduction","C1432102","","16.92","3889.68"
"1519","TCCL1002 - KUMAR CABLE NETWORK ( TNTDNTCCL1002 ) ","2023-11-25 19:24:15","DDL1765114979","Deduction","C1432102","","7.08","3882.6"
"1520","TCCL1002 - KUMAR CABLE NETWORK ( TNTDNTCCL1002 ) ","2023-12-08 13:04:04","TR21399831","Adjustment (classic sd pack discount 165*5 nov 2023) ","","825.00","","4707.6"
"1521","TCCL1002 - KUMAR CABLE NETWORK ( TNTDNTCCL1002 ) ","2023-12-10 18:54:12","DDL1770309149","Deduction","C1291189","","60.05","4647.55"
"1522","TCCL1002 - KUMAR CABLE NETWORK ( TNTDNTCCL1002 ) ","2023-12-10 18:54:12","DDL1770309154","Deduction","C1291189","","25.13","4622.42"
"1523","TCCL1002 - KUMAR CABLE NETWORK ( TNTDNTCCL1002 ) ","2023-12-11 15:36:20","TR21509513","Adjustment (credit note for december-2023 life time stb ncf bill(1*35.40)) ","","35.40","","4657.82"
"1524","TCCL1002 - KUMAR CABLE NETWORK ( TNTDNTCCL1002 ) ","2023-12-11 16:26:26","DDL1770627534","Deduction","C5714740","","35.40","4622.42"
"1525","TCCL1002 - KUMAR CABLE NETWORK ( TNTDNTCCL1002 ) ","2023-12-17 19:01:10","DDL1774477734","Deduction","C1554617","","40.94","4581.48"
"1526","TCCL1002 - KUMAR CABLE NETWORK ( TNTDNTCCL1002 ) ","2023-12-17 19:01:10","DDL1774477739","Deduction","C1554617","","17.13","4564.35"
"1527","TCCL1002 - KUMAR CABLE NETWORK ( TNTDNTCCL1002 ) ","2023-12-17 19:01:10","DDL1774477744","Deduction","C1554617","","11.42","4552.93"
"1528","TCCL1002 - KUMAR CABLE NETWORK ( TNTDNTCCL1002 ) ","2023-12-17 19:01:10","DDL1774477749","Deduction","C1554617","","27.30","4525.63"
"1529","TCCL1002 - KUMAR CABLE NETWORK ( TNTDNTCCL1002 ) ","2023-12-20 22:47:38","TR21825359","Normal Deposit (Lco Amount Deposited from Lco Portal. EASEBUZZ payment with Ref No- RC_Krb7FJ) ","","21200.00","","25725.63"
"1530","TCCL1002 - KUMAR CABLE NETWORK ( TNTDNTCCL1002 ) ","2023-12-20 23:01:23","DDL1784468542","Deduction","C0757509","","35.40","25690.23"
"1531","TCCL1002 - KUMAR CABLE NETWORK ( TNTDNTCCL1002 ) ","2023-12-20 23:01:23","DDL1784468547","Deduction","C0757509","","84.61","25605.62"
"1532","TCCL1002 - KUMAR CABLE NETWORK ( TNTDNTCCL1002 ) ","2023-12-20 23:01:23","DDL1784468557","Deduction","C1250634","","35.40","25570.22"
"1533","TCCL1002 - KUMAR CABLE NETWORK ( TNTDNTCCL1002 ) ","2023-12-20 23:01:23","DDL1784468562","Deduction","C1250634","","84.61","25485.61"
"1534","TCCL1002 - KUMAR CABLE NETWORK ( TNTDNTCCL1002 ) ","2023-12-20 23:01:23","DDL1784468567","Deduction","C1432101","","35.40","25450.21"
"1535","TCCL1002 - KUMAR CABLE NETWORK ( TNTDNTCCL1002 ) ","2023-12-20 23:01:23","DDL1784468572","Deduction","C1432101","","84.61","25365.6"
"1536","TCCL1002 - KUMAR CABLE NETWORK ( TNTDNTCCL1002 ) ","2023-12-20 23:01:24","DDL1784468592","Deduction","C3896312","","35.40","25330.2"
"1537","TCCL1002 - KUMAR CABLE NETWORK ( TNTDNTCCL1002 ) ","2023-12-20 23:01:24","DDL1784468597","Deduction","C3896312","","84.61","25245.59"
"1538","TCCL1002 - KUMAR CABLE NETWORK ( TNTDNTCCL1002 ) ","2023-12-20 23:01:24","DDL1784468607","Deduction","C1238666","","35.40","25210.19"
"1539","TCCL1002 - KUMAR CABLE NETWORK ( TNTDNTCCL1002 ) ","2023-12-20 23:01:24","DDL1784468612","Deduction","C1238666","","84.61","25125.58"
"1540","TCCL1002 - KUMAR CABLE NETWORK ( TNTDNTCCL1002 ) ","2023-12-20 23:01:24","DDL1784468622","Deduction","C2227396","","35.40","25090.18"
"1541","TCCL1002 - KUMAR CABLE NETWORK ( TNTDNTCCL1002 ) ","2023-12-20 23:01:24","DDL1784468627","Deduction","C2227396","","84.61","25005.57"
"1542","TCCL1002 - KUMAR CABLE NETWORK ( TNTDNTCCL1002 ) ","2023-12-20 23:01:24","DDL1784468637","Deduction","C1437253","","35.40","24970.17"
"1543","TCCL1002 - KUMAR CABLE NETWORK ( TNTDNTCCL1002 ) ","2023-12-20 23:01:24","DDL1784468642","Deduction","C1437253","","84.61","24885.56"
"1544","TCCL1002 - KUMAR CABLE NETWORK ( TNTDNTCCL1002 ) ","2023-12-20 23:01:24","DDL1784468652","Deduction","C6267661","","35.40","24850.16"
"1545","TCCL1002 - KUMAR CABLE NETWORK ( TNTDNTCCL1002 ) ","2023-12-20 23:01:24","DDL1784468657","Deduction","C6267661","","84.61","24765.55"
"1546","TCCL1002 - KUMAR CABLE NETWORK ( TNTDNTCCL1002 ) ","2023-12-20 23:01:24","DDL1784468667","Deduction","C1468102","","35.40","24730.15"
"1547","TCCL1002 - KUMAR CABLE NETWORK ( TNTDNTCCL1002 ) ","2023-12-20 23:01:24","DDL1784468672","Deduction","C1468102","","84.61","24645.54"
"1548","TCCL1002 - KUMAR CABLE NETWORK ( TNTDNTCCL1002 ) ","2023-12-20 23:01:24","DDL1784468707","Deduction","C1427120","","35.40","24610.14"
"1549","TCCL1002 - KUMAR CABLE NETWORK ( TNTDNTCCL1002 ) ","2023-12-20 23:01:24","DDL1784468712","Deduction","C1427120","","84.61","24525.53"
"1550","TCCL1002 - KUMAR CABLE NETWORK ( TNTDNTCCL1002 ) ","2023-12-20 23:01:24","DDL1784468722","Deduction","C1554612","","35.40","24490.13"
"1551","TCCL1002 - KUMAR CABLE NETWORK ( TNTDNTCCL1002 ) ","2023-12-20 23:01:24","DDL1784468727","Deduction","C1554612","","84.61","24405.52"
"1552","TCCL1002 - KUMAR CABLE NETWORK ( TNTDNTCCL1002 ) ","2023-12-20 23:01:24","DDL1784468737","Deduction","C4300554","","35.40","24370.12"
"1553","TCCL1002 - KUMAR CABLE NETWORK ( TNTDNTCCL1002 ) ","2023-12-20 23:01:24","DDL1784468742","Deduction","C4300554","","84.61","24285.51"
"1554","TCCL1002 - KUMAR CABLE NETWORK ( TNTDNTCCL1002 ) ","2023-12-20 23:01:24","DDL1784468752","Deduction","C5684330","","35.40","24250.11"
"1555","TCCL1002 - KUMAR CABLE NETWORK ( TNTDNTCCL1002 ) ","2023-12-20 23:01:24","DDL1784468757","Deduction","C5684330","","84.61","24165.5"
"1556","TCCL1002 - KUMAR CABLE NETWORK ( TNTDNTCCL1002 ) ","2023-12-20 23:01:24","DDL1784468772","Deduction","C2161413","","35.40","24130.1"
"1557","TCCL1002 - KUMAR CABLE NETWORK ( TNTDNTCCL1002 ) ","2023-12-20 23:01:24","DDL1784468777","Deduction","C2161413","","84.61","24045.49"
"1558","TCCL1002 - KUMAR CABLE NETWORK ( TNTDNTCCL1002 ) ","2023-12-20 23:01:24","DDL1784468792","Deduction","C1426984","","35.40","24010.09"
"1559","TCCL1002 - KUMAR CABLE NETWORK ( TNTDNTCCL1002 ) ","2023-12-20 23:01:24","DDL1784468797","Deduction","C1426984","","84.61","23925.48"
"1560","TCCL1002 - KUMAR CABLE NETWORK ( TNTDNTCCL1002 ) ","2023-12-20 23:01:24","DDL1784468802","Deduction","C1426984","","20.18","23905.3"
"1561","TCCL1002 - KUMAR CABLE NETWORK ( TNTDNTCCL1002 ) ","2023-12-20 23:01:24","DDL1784468807","Deduction","C1426984","","20.18","23885.12"
"1562","TCCL1002 - KUMAR CABLE NETWORK ( TNTDNTCCL1002 ) ","2023-12-20 23:01:24","DDL1784468812","Deduction","C1426984","","20.18","23864.94"
"1563","TCCL1002 - KUMAR CABLE NETWORK ( TNTDNTCCL1002 ) ","2023-12-20 23:01:24","DDL1784468822","Deduction","C1496002","","35.40","23829.54"
"1564","TCCL1002 - KUMAR CABLE NETWORK ( TNTDNTCCL1002 ) ","2023-12-20 23:01:24","DDL1784468827","Deduction","C1496002","","84.61","23744.93"
"1565","TCCL1002 - KUMAR CABLE NETWORK ( TNTDNTCCL1002 ) ","2023-12-20 23:01:24","DDL1784468837","Deduction","C1291196","","35.40","23709.53"
"1566","TCCL1002 - KUMAR CABLE NETWORK ( TNTDNTCCL1002 ) ","2023-12-20 23:01:24","DDL1784468842","Deduction","C1291196","","84.61","23624.92"
"1567","TCCL1002 - KUMAR CABLE NETWORK ( TNTDNTCCL1002 ) ","2023-12-20 23:01:25","DDL1784468852","Deduction","C2558795","","35.40","23589.52"
"1568","TCCL1002 - KUMAR CABLE NETWORK ( TNTDNTCCL1002 ) ","2023-12-20 23:01:25","DDL1784468857","Deduction","C2558795","","84.61","23504.91"
"1569","TCCL1002 - KUMAR CABLE NETWORK ( TNTDNTCCL1002 ) ","2023-12-20 23:01:25","DDL1784468867","Deduction","C12371501","","35.40","23469.51"
"1570","TCCL1002 - KUMAR CABLE NETWORK ( TNTDNTCCL1002 ) ","2023-12-20 23:01:25","DDL1784468872","Deduction","C12371501","","84.61","23384.9"
"1571","TCCL1002 - KUMAR CABLE NETWORK ( TNTDNTCCL1002 ) ","2023-12-20 23:01:25","DDL1784468877","Deduction","C5575416","","35.40","23349.5"
"1572","TCCL1002 - KUMAR CABLE NETWORK ( TNTDNTCCL1002 ) ","2023-12-20 23:01:25","DDL1784468882","Deduction","C5575416","","84.61","23264.89"
"1573","TCCL1002 - KUMAR CABLE NETWORK ( TNTDNTCCL1002 ) ","2023-12-20 23:01:25","DDL1784468887","Deduction","C1437301","","35.40","23229.49"
"1574","TCCL1002 - KUMAR CABLE NETWORK ( TNTDNTCCL1002 ) ","2023-12-20 23:01:25","DDL1784468892","Deduction","C1437301","","84.61","23144.88"
"1575","TCCL1002 - KUMAR CABLE NETWORK ( TNTDNTCCL1002 ) ","2023-12-20 23:01:25","DDL1784468897","Deduction","C1992670","","35.40","23109.48"
"1576","TCCL1002 - KUMAR CABLE NETWORK ( TNTDNTCCL1002 ) ","2023-12-20 23:01:25","DDL1784468902","Deduction","C1992670","","84.61","23024.87"
"1577","TCCL1002 - KUMAR CABLE NETWORK ( TNTDNTCCL1002 ) ","2023-12-20 23:01:25","DDL1784468912","Deduction","C0798097","","35.40","22989.47"
"1578","TCCL1002 - KUMAR CABLE NETWORK ( TNTDNTCCL1002 ) ","2023-12-20 23:01:25","DDL1784468917","Deduction","C0798097","","84.61","22904.86"
"1579","TCCL1002 - KUMAR CABLE NETWORK ( TNTDNTCCL1002 ) ","2023-12-20 23:01:25","DDL1784468922","Deduction","C1693300","","35.40","22869.46"
"1580","TCCL1002 - KUMAR CABLE NETWORK ( TNTDNTCCL1002 ) ","2023-12-20 23:01:25","DDL1784468927","Deduction","C1693300","","84.61","22784.85"
"1581","TCCL1002 - KUMAR CABLE NETWORK ( TNTDNTCCL1002 ) ","2023-12-20 23:01:25","DDL1784468937","Deduction","C1010622","","35.40","22749.45"
"1582","TCCL1002 - KUMAR CABLE NETWORK ( TNTDNTCCL1002 ) ","2023-12-20 23:01:25","DDL1784468942","Deduction","C1010622","","84.61","22664.84"
"1583","TCCL1002 - KUMAR CABLE NETWORK ( TNTDNTCCL1002 ) ","2023-12-20 23:01:25","DDL1784468947","Deduction","C1087161","","35.40","22629.44"
"1584","TCCL1002 - KUMAR CABLE NETWORK ( TNTDNTCCL1002 ) ","2023-12-20 23:01:25","DDL1784468952","Deduction","C1087161","","124.60","22504.84"
"1585","TCCL1002 - KUMAR CABLE NETWORK ( TNTDNTCCL1002 ) ","2023-12-20 23:01:25","DDL1784468957","Deduction","C3379807","","35.40","22469.44"
"1586","TCCL1002 - KUMAR CABLE NETWORK ( TNTDNTCCL1002 ) ","2023-12-20 23:01:25","DDL1784468967","Deduction","C3379807","","84.61","22384.83"
"1587","TCCL1002 - KUMAR CABLE NETWORK ( TNTDNTCCL1002 ) ","2023-12-20 23:01:25","DDL1784468977","Deduction","C7395841","","35.40","22349.43"
"1588","TCCL1002 - KUMAR CABLE NETWORK ( TNTDNTCCL1002 ) ","2023-12-20 23:01:25","DDL1784468982","Deduction","C7395841","","84.61","22264.82"
"1589","TCCL1002 - KUMAR CABLE NETWORK ( TNTDNTCCL1002 ) ","2023-12-20 23:01:25","DDL1784468992","Deduction","C1432102","","35.40","22229.42"
"1590","TCCL1002 - KUMAR CABLE NETWORK ( TNTDNTCCL1002 ) ","2023-12-20 23:01:25","DDL1784468997","Deduction","C1432102","","84.61","22144.81"
"1591","TCCL1002 - KUMAR CABLE NETWORK ( TNTDNTCCL1002 ) ","2023-12-20 23:01:25","DDL1784469012","Deduction","C1426720","","35.40","22109.41"
"1592","TCCL1002 - KUMAR CABLE NETWORK ( TNTDNTCCL1002 ) ","2023-12-20 23:01:25","DDL1784469017","Deduction","C1426720","","84.61","22024.8"
"1593","TCCL1002 - KUMAR CABLE NETWORK ( TNTDNTCCL1002 ) ","2023-12-20 23:01:25","DDL1784469032","Deduction","C5130819","","35.40","21989.4"
"1594","TCCL1002 - KUMAR CABLE NETWORK ( TNTDNTCCL1002 ) ","2023-12-20 23:01:25","DDL1784469037","Deduction","C5130819","","84.61","21904.79"
"1595","TCCL1002 - KUMAR CABLE NETWORK ( TNTDNTCCL1002 ) ","2023-12-20 23:01:25","DDL1784469052","Deduction","C1425593","","35.40","21869.39"
"1596","TCCL1002 - KUMAR CABLE NETWORK ( TNTDNTCCL1002 ) ","2023-12-20 23:01:25","DDL1784469057","Deduction","C1425593","","84.61","21784.78"
"1597","TCCL1002 - KUMAR CABLE NETWORK ( TNTDNTCCL1002 ) ","2023-12-20 23:01:25","DDL1784469072","Deduction","C1459332","","35.40","21749.38"
"1598","TCCL1002 - KUMAR CABLE NETWORK ( TNTDNTCCL1002 ) ","2023-12-20 23:01:25","DDL1784469077","Deduction","C1459332","","84.61","21664.77"
"1599","TCCL1002 - KUMAR CABLE NETWORK ( TNTDNTCCL1002 ) ","2023-12-20 23:01:26","DDL1784469087","Deduction","C2334200","","35.40","21629.37"
"1600","TCCL1002 - KUMAR CABLE NETWORK ( TNTDNTCCL1002 ) ","2023-12-20 23:01:26","DDL1784469092","Deduction","C2334200","","84.61","21544.76"
"1601","TCCL1002 - KUMAR CABLE NETWORK ( TNTDNTCCL1002 ) ","2023-12-20 23:01:26","DDL1784469107","Deduction","C1468093","","35.40","21509.36"
"1602","TCCL1002 - KUMAR CABLE NETWORK ( TNTDNTCCL1002 ) ","2023-12-20 23:01:26","DDL1784469112","Deduction","C1468093","","84.61","21424.75"
"1603","TCCL1002 - KUMAR CABLE NETWORK ( TNTDNTCCL1002 ) ","2023-12-20 23:01:26","DDL1784469122","Deduction","C1693302","","35.40","21389.35"
"1604","TCCL1002 - KUMAR CABLE NETWORK ( TNTDNTCCL1002 ) ","2023-12-20 23:01:26","DDL1784469127","Deduction","C1693302","","84.61","21304.74"
"1605","TCCL1002 - KUMAR CABLE NETWORK ( TNTDNTCCL1002 ) ","2023-12-20 23:01:26","DDL1784469137","Deduction","C12862375","","35.40","21269.34"
"1606","TCCL1002 - KUMAR CABLE NETWORK ( TNTDNTCCL1002 ) ","2023-12-20 23:01:26","DDL1784469142","Deduction","C12862375","","84.61","21184.73"
"1607","TCCL1002 - KUMAR CABLE NETWORK ( TNTDNTCCL1002 ) ","2023-12-20 23:01:26","DDL1784469157","Deduction","C1554615","","35.40","21149.33"
"1608","TCCL1002 - KUMAR CABLE NETWORK ( TNTDNTCCL1002 ) ","2023-12-20 23:01:26","DDL1784469167","Deduction","C1554615","","84.61","21064.72"
"1609","TCCL1002 - KUMAR CABLE NETWORK ( TNTDNTCCL1002 ) ","2023-12-20 23:01:26","DDL1784469182","Deduction","C5130647","","35.40","21029.32"
"1610","TCCL1002 - KUMAR CABLE NETWORK ( TNTDNTCCL1002 ) ","2023-12-20 23:01:26","DDL1784469187","Deduction","C5130647","","84.61","20944.71"
"1611","TCCL1002 - KUMAR CABLE NETWORK ( TNTDNTCCL1002 ) ","2023-12-20 23:01:26","DDL1784469192","Deduction","C5130647","","20.18","20924.53"
"1612","TCCL1002 - KUMAR CABLE NETWORK ( TNTDNTCCL1002 ) ","2023-12-20 23:01:26","DDL1784469197","Deduction","C5130647","","20.18","20904.35"
"1613","TCCL1002 - KUMAR CABLE NETWORK ( TNTDNTCCL1002 ) ","2023-12-20 23:01:26","DDL1784469202","Deduction","C5130647","","20.18","20884.17"
"1614","TCCL1002 - KUMAR CABLE NETWORK ( TNTDNTCCL1002 ) ","2023-12-20 23:01:26","DDL1784469212","Deduction","C1495996","","35.40","20848.77"
"1615","TCCL1002 - KUMAR CABLE NETWORK ( TNTDNTCCL1002 ) ","2023-12-20 23:01:26","DDL1784469217","Deduction","C1495996","","84.61","20764.16"
"1616","TCCL1002 - KUMAR CABLE NETWORK ( TNTDNTCCL1002 ) ","2023-12-20 23:01:26","DDL1784469227","Deduction","C1448881","","35.40","20728.76"
"1617","TCCL1002 - KUMAR CABLE NETWORK ( TNTDNTCCL1002 ) ","2023-12-20 23:01:26","DDL1784469232","Deduction","C1448881","","84.61","20644.15"
"1618","TCCL1002 - KUMAR CABLE NETWORK ( TNTDNTCCL1002 ) ","2023-12-20 23:01:26","DDL1784469242","Deduction","C4993282","","35.40","20608.75"
"1619","TCCL1002 - KUMAR CABLE NETWORK ( TNTDNTCCL1002 ) ","2023-12-20 23:01:26","DDL1784469247","Deduction","C4993282","","84.61","20524.14"
"1620","TCCL1002 - KUMAR CABLE NETWORK ( TNTDNTCCL1002 ) ","2023-12-20 23:01:26","DDL1784469252","Deduction","C1468095","","35.40","20488.74"
"1621","TCCL1002 - KUMAR CABLE NETWORK ( TNTDNTCCL1002 ) ","2023-12-20 23:01:26","DDL1784469257","Deduction","C1468095","","84.61","20404.13"
"1622","TCCL1002 - KUMAR CABLE NETWORK ( TNTDNTCCL1002 ) ","2023-12-20 23:01:26","DDL1784469267","Deduction","C4183113","","35.40","20368.73"
"1623","TCCL1002 - KUMAR CABLE NETWORK ( TNTDNTCCL1002 ) ","2023-12-20 23:01:26","DDL1784469272","Deduction","C4183113","","84.61","20284.12"
"1624","TCCL1002 - KUMAR CABLE NETWORK ( TNTDNTCCL1002 ) ","2023-12-20 23:01:26","DDL1784469282","Deduction","C1291191","","35.40","20248.72"
"1625","TCCL1002 - KUMAR CABLE NETWORK ( TNTDNTCCL1002 ) ","2023-12-20 23:01:26","DDL1784469287","Deduction","C1291191","","84.61","20164.11"
"1626","TCCL1002 - KUMAR CABLE NETWORK ( TNTDNTCCL1002 ) ","2023-12-20 23:01:26","DDL1784469297","Deduction","C1427146","","35.40","20128.71"
"1627","TCCL1002 - KUMAR CABLE NETWORK ( TNTDNTCCL1002 ) ","2023-12-20 23:01:26","DDL1784469302","Deduction","C1427146","","84.61","20044.1"
"1628","TCCL1002 - KUMAR CABLE NETWORK ( TNTDNTCCL1002 ) ","2023-12-20 23:01:26","DDL1784469312","Deduction","C1237806","","35.40","20008.7"
"1629","TCCL1002 - KUMAR CABLE NETWORK ( TNTDNTCCL1002 ) ","2023-12-20 23:01:26","DDL1784469317","Deduction","C1237806","","84.61","19924.09"
"1630","TCCL1002 - KUMAR CABLE NETWORK ( TNTDNTCCL1002 ) ","2023-12-20 23:01:26","DDL1784469322","Deduction","C12826763","","35.40","19888.69"
"1631","TCCL1002 - KUMAR CABLE NETWORK ( TNTDNTCCL1002 ) ","2023-12-20 23:01:26","DDL1784469327","Deduction","C12826763","","84.61","19804.08"
"1632","TCCL1002 - KUMAR CABLE NETWORK ( TNTDNTCCL1002 ) ","2023-12-20 23:01:26","DDL1784469332","Deduction","C5056626","","35.40","19768.68"
"1633","TCCL1002 - KUMAR CABLE NETWORK ( TNTDNTCCL1002 ) ","2023-12-20 23:01:26","DDL1784469337","Deduction","C5056626","","84.61","19684.07"
"1634","TCCL1002 - KUMAR CABLE NETWORK ( TNTDNTCCL1002 ) ","2023-12-20 23:01:27","DDL1784469342","Deduction","C1468097","","35.40","19648.67"
"1635","TCCL1002 - KUMAR CABLE NETWORK ( TNTDNTCCL1002 ) ","2023-12-20 23:01:27","DDL1784469347","Deduction","C1468097","","84.61","19564.06"
"1636","TCCL1002 - KUMAR CABLE NETWORK ( TNTDNTCCL1002 ) ","2023-12-20 23:01:27","DDL1784469357","Deduction","C3737584","","35.40","19528.66"
"1637","TCCL1002 - KUMAR CABLE NETWORK ( TNTDNTCCL1002 ) ","2023-12-20 23:01:27","DDL1784469362","Deduction","C3737584","","84.61","19444.05"
"1638","TCCL1002 - KUMAR CABLE NETWORK ( TNTDNTCCL1002 ) ","2023-12-20 23:01:27","DDL1784469367","Deduction","C1468101","","35.40","19408.65"
"1639","TCCL1002 - KUMAR CABLE NETWORK ( TNTDNTCCL1002 ) ","2023-12-20 23:01:27","DDL1784469372","Deduction","C1468101","","84.61","19324.04"
"1640","TCCL1002 - KUMAR CABLE NETWORK ( TNTDNTCCL1002 ) ","2023-12-20 23:01:27","DDL1784469382","Deduction","C2149806","","35.40","19288.64"
"1641","TCCL1002 - KUMAR CABLE NETWORK ( TNTDNTCCL1002 ) ","2023-12-20 23:01:27","DDL1784469387","Deduction","C2149806","","84.61","19204.03"
"1642","TCCL1002 - KUMAR CABLE NETWORK ( TNTDNTCCL1002 ) ","2023-12-20 23:01:27","DDL1784469392","Deduction","C1427055","","35.40","19168.63"
"1643","TCCL1002 - KUMAR CABLE NETWORK ( TNTDNTCCL1002 ) ","2023-12-20 23:01:27","DDL1784469397","Deduction","C1427055","","84.61","19084.02"
"1644","TCCL1002 - KUMAR CABLE NETWORK ( TNTDNTCCL1002 ) ","2023-12-20 23:01:27","DDL1784469402","Deduction","C6351898","","35.40","19048.62"
"1645","TCCL1002 - KUMAR CABLE NETWORK ( TNTDNTCCL1002 ) ","2023-12-20 23:01:27","DDL1784469407","Deduction","C6351898","","84.61","18964.01"
"1646","TCCL1002 - KUMAR CABLE NETWORK ( TNTDNTCCL1002 ) ","2023-12-20 23:01:27","DDL1784469417","Deduction","C1427641","","35.40","18928.61"
"1647","TCCL1002 - KUMAR CABLE NETWORK ( TNTDNTCCL1002 ) ","2023-12-20 23:01:27","DDL1784469422","Deduction","C1427641","","84.61","18844"
"1648","TCCL1002 - KUMAR CABLE NETWORK ( TNTDNTCCL1002 ) ","2023-12-20 23:01:27","DDL1784469427","Deduction","C1432090","","35.40","18808.6"
"1649","TCCL1002 - KUMAR CABLE NETWORK ( TNTDNTCCL1002 ) ","2023-12-20 23:01:27","DDL1784469432","Deduction","C1432090","","84.61","18723.99"
"1650","TCCL1002 - KUMAR CABLE NETWORK ( TNTDNTCCL1002 ) ","2023-12-20 23:01:27","DDL1784469437","Deduction","C1244143","","35.40","18688.59"
"1651","TCCL1002 - KUMAR CABLE NETWORK ( TNTDNTCCL1002 ) ","2023-12-20 23:01:27","DDL1784469442","Deduction","C1244143","","84.61","18603.98"
"1652","TCCL1002 - KUMAR CABLE NETWORK ( TNTDNTCCL1002 ) ","2023-12-20 23:01:27","DDL1784469457","Deduction","C4073642","","35.40","18568.58"
"1653","TCCL1002 - KUMAR CABLE NETWORK ( TNTDNTCCL1002 ) ","2023-12-20 23:01:27","DDL1784469462","Deduction","C4073642","","84.61","18483.97"
"1654","TCCL1002 - KUMAR CABLE NETWORK ( TNTDNTCCL1002 ) ","2023-12-20 23:01:27","DDL1784469467","Deduction","C4300560","","35.40","18448.57"
"1655","TCCL1002 - KUMAR CABLE NETWORK ( TNTDNTCCL1002 ) ","2023-12-20 23:01:27","DDL1784469472","Deduction","C4300560","","84.61","18363.96"
"1656","TCCL1002 - KUMAR CABLE NETWORK ( TNTDNTCCL1002 ) ","2023-12-20 23:01:27","DDL1784469477","Deduction","C3875743","","35.40","18328.56"
"1657","TCCL1002 - KUMAR CABLE NETWORK ( TNTDNTCCL1002 ) ","2023-12-20 23:01:27","DDL1784469482","Deduction","C3875743","","84.61","18243.95"
"1658","TCCL1002 - KUMAR CABLE NETWORK ( TNTDNTCCL1002 ) ","2023-12-20 23:01:27","DDL1784469492","Deduction","C1459352","","35.40","18208.55"
"1659","TCCL1002 - KUMAR CABLE NETWORK ( TNTDNTCCL1002 ) ","2023-12-20 23:01:27","DDL1784469497","Deduction","C1459352","","84.61","18123.94"
"1660","TCCL1002 - KUMAR CABLE NETWORK ( TNTDNTCCL1002 ) ","2023-12-20 23:01:27","DDL1784469507","Deduction","C0769247","","35.40","18088.54"
"1661","TCCL1002 - KUMAR CABLE NETWORK ( TNTDNTCCL1002 ) ","2023-12-20 23:01:27","DDL1784469512","Deduction","C0769247","","84.61","18003.93"
"1662","TCCL1002 - KUMAR CABLE NETWORK ( TNTDNTCCL1002 ) ","2023-12-20 23:01:27","DDL1784469517","Deduction","C0756488","","35.40","17968.53"
"1663","TCCL1002 - KUMAR CABLE NETWORK ( TNTDNTCCL1002 ) ","2023-12-20 23:01:27","DDL1784469522","Deduction","C0756488","","84.61","17883.92"
"1664","TCCL1002 - KUMAR CABLE NETWORK ( TNTDNTCCL1002 ) ","2023-12-20 23:01:28","DDL1784469527","Deduction","C3342594","","35.40","17848.52"
"1665","TCCL1002 - KUMAR CABLE NETWORK ( TNTDNTCCL1002 ) ","2023-12-20 23:01:28","DDL1784469532","Deduction","C3342594","","84.61","17763.91"
"1666","TCCL1002 - KUMAR CABLE NETWORK ( TNTDNTCCL1002 ) ","2023-12-20 23:01:28","DDL1784469537","Deduction","C1437360","","35.40","17728.51"
"1667","TCCL1002 - KUMAR CABLE NETWORK ( TNTDNTCCL1002 ) ","2023-12-20 23:01:28","DDL1784469542","Deduction","C1437360","","84.61","17643.9"
"1668","TCCL1002 - KUMAR CABLE NETWORK ( TNTDNTCCL1002 ) ","2023-12-20 23:01:28","DDL1784469552","Deduction","C2334438","","35.40","17608.5"
"1669","TCCL1002 - KUMAR CABLE NETWORK ( TNTDNTCCL1002 ) ","2023-12-20 23:01:28","DDL1784469557","Deduction","C2334438","","84.61","17523.89"
"1670","TCCL1002 - KUMAR CABLE NETWORK ( TNTDNTCCL1002 ) ","2023-12-20 23:01:28","DDL1784469567","Deduction","C0769358","","35.40","17488.49"
"1671","TCCL1002 - KUMAR CABLE NETWORK ( TNTDNTCCL1002 ) ","2023-12-20 23:01:28","DDL1784469572","Deduction","C0769358","","84.61","17403.88"
"1672","TCCL1002 - KUMAR CABLE NETWORK ( TNTDNTCCL1002 ) ","2023-12-20 23:01:28","DDL1784469582","Deduction","C7832592","","35.40","17368.48"
"1673","TCCL1002 - KUMAR CABLE NETWORK ( TNTDNTCCL1002 ) ","2023-12-20 23:01:28","DDL1784469587","Deduction","C7832592","","84.61","17283.87"
"1674","TCCL1002 - KUMAR CABLE NETWORK ( TNTDNTCCL1002 ) ","2023-12-20 23:01:28","DDL1784469592","Deduction","C4184972","","35.40","17248.47"
"1675","TCCL1002 - KUMAR CABLE NETWORK ( TNTDNTCCL1002 ) ","2023-12-20 23:01:28","DDL1784469597","Deduction","C4184972","","84.61","17163.86"
"1676","TCCL1002 - KUMAR CABLE NETWORK ( TNTDNTCCL1002 ) ","2023-12-20 23:01:28","DDL1784469602","Deduction","C6144382","","35.40","17128.46"
"1677","TCCL1002 - KUMAR CABLE NETWORK ( TNTDNTCCL1002 ) ","2023-12-20 23:01:28","DDL1784469607","Deduction","C6144382","","84.61","17043.85"
"1678","TCCL1002 - KUMAR CABLE NETWORK ( TNTDNTCCL1002 ) ","2023-12-20 23:01:28","DDL1784469612","Deduction","C1693301","","35.40","17008.45"
"1679","TCCL1002 - KUMAR CABLE NETWORK ( TNTDNTCCL1002 ) ","2023-12-20 23:01:28","DDL1784469617","Deduction","C1693301","","124.60","16883.85"
"1680","TCCL1002 - KUMAR CABLE NETWORK ( TNTDNTCCL1002 ) ","2023-12-20 23:01:28","DDL1784469627","Deduction","C2120530","","35.40","16848.45"
"1681","TCCL1002 - KUMAR CABLE NETWORK ( TNTDNTCCL1002 ) ","2023-12-20 23:01:28","DDL1784469632","Deduction","C2120530","","84.61","16763.84"
"1682","TCCL1002 - KUMAR CABLE NETWORK ( TNTDNTCCL1002 ) ","2023-12-20 23:01:28","DDL1784469637","Deduction","C1427006","","35.40","16728.44"
"1683","TCCL1002 - KUMAR CABLE NETWORK ( TNTDNTCCL1002 ) ","2023-12-20 23:01:28","DDL1784469642","Deduction","C1427006","","84.61","16643.83"
"1684","TCCL1002 - KUMAR CABLE NETWORK ( TNTDNTCCL1002 ) ","2023-12-20 23:01:28","DDL1784469647","Deduction","C5076832","","35.40","16608.43"
"1685","TCCL1002 - KUMAR CABLE NETWORK ( TNTDNTCCL1002 ) ","2023-12-20 23:01:28","DDL1784469652","Deduction","C5076832","","84.61","16523.82"
"1686","TCCL1002 - KUMAR CABLE NETWORK ( TNTDNTCCL1002 ) ","2023-12-20 23:01:28","DDL1784469657","Deduction","C2051654","","35.40","16488.42"
"1687","TCCL1002 - KUMAR CABLE NETWORK ( TNTDNTCCL1002 ) ","2023-12-20 23:01:28","DDL1784469662","Deduction","C2051654","","84.61","16403.81"
"1688","TCCL1002 - KUMAR CABLE NETWORK ( TNTDNTCCL1002 ) ","2023-12-20 23:01:28","DDL1784469672","Deduction","C1554069","","35.40","16368.41"
"1689","TCCL1002 - KUMAR CABLE NETWORK ( TNTDNTCCL1002 ) ","2023-12-20 23:01:28","DDL1784469677","Deduction","C1554069","","84.61","16283.8"
"1690","TCCL1002 - KUMAR CABLE NETWORK ( TNTDNTCCL1002 ) ","2023-12-20 23:01:28","DDL1784469687","Deduction","C1010021","","35.40","16248.4"
"1691","TCCL1002 - KUMAR CABLE NETWORK ( TNTDNTCCL1002 ) ","2023-12-20 23:01:28","DDL1784469692","Deduction","C1010021","","84.61","16163.79"
"1692","TCCL1002 - KUMAR CABLE NETWORK ( TNTDNTCCL1002 ) ","2023-12-20 23:01:28","DDL1784469702","Deduction","C11942814","","35.40","16128.39"
"1693","TCCL1002 - KUMAR CABLE NETWORK ( TNTDNTCCL1002 ) ","2023-12-20 23:01:28","DDL1784469707","Deduction","C11942814","","84.61","16043.78"
"1694","TCCL1002 - KUMAR CABLE NETWORK ( TNTDNTCCL1002 ) ","2023-12-20 23:01:28","DDL1784469717","Deduction","C2266442","","35.40","16008.38"
"1695","TCCL1002 - KUMAR CABLE NETWORK ( TNTDNTCCL1002 ) ","2023-12-20 23:01:29","DDL1784469722","Deduction","C2266442","","84.61","15923.77"
"1696","TCCL1002 - KUMAR CABLE NETWORK ( TNTDNTCCL1002 ) ","2023-12-20 23:01:29","DDL1784469732","Deduction","C5146791","","35.40","15888.37"
"1697","TCCL1002 - KUMAR CABLE NETWORK ( TNTDNTCCL1002 ) ","2023-12-20 23:01:29","DDL1784469737","Deduction","C5146791","","84.61","15803.76"
"1698","TCCL1002 - KUMAR CABLE NETWORK ( TNTDNTCCL1002 ) ","2023-12-20 23:01:29","DDL1784469747","Deduction","C8719391","","35.40","15768.36"
"1699","TCCL1002 - KUMAR CABLE NETWORK ( TNTDNTCCL1002 ) ","2023-12-20 23:01:29","DDL1784469752","Deduction","C8719391","","84.61","15683.75"
"1700","TCCL1002 - KUMAR CABLE NETWORK ( TNTDNTCCL1002 ) ","2023-12-20 23:01:29","DDL1784469772","Deduction","C1676819","","35.40","15648.35"
"1701","TCCL1002 - KUMAR CABLE NETWORK ( TNTDNTCCL1002 ) ","2023-12-20 23:01:29","DDL1784469777","Deduction","C1676819","","84.61","15563.74"
"1702","TCCL1002 - KUMAR CABLE NETWORK ( TNTDNTCCL1002 ) ","2023-12-20 23:01:29","DDL1784469787","Deduction","C1459282","","35.40","15528.34"
"1703","TCCL1002 - KUMAR CABLE NETWORK ( TNTDNTCCL1002 ) ","2023-12-20 23:01:29","DDL1784469792","Deduction","C1459282","","84.61","15443.73"
"1704","TCCL1002 - KUMAR CABLE NETWORK ( TNTDNTCCL1002 ) ","2023-12-20 23:01:29","DDL1784469802","Deduction","C1291192","","35.40","15408.33"
"1705","TCCL1002 - KUMAR CABLE NETWORK ( TNTDNTCCL1002 ) ","2023-12-20 23:01:29","DDL1784469807","Deduction","C1291192","","84.61","15323.72"
"1706","TCCL1002 - KUMAR CABLE NETWORK ( TNTDNTCCL1002 ) ","2023-12-20 23:01:29","DDL1784469817","Deduction","C4300557","","35.40","15288.32"
"1707","TCCL1002 - KUMAR CABLE NETWORK ( TNTDNTCCL1002 ) ","2023-12-20 23:01:29","DDL1784469822","Deduction","C4300557","","84.61","15203.71"
"1708","TCCL1002 - KUMAR CABLE NETWORK ( TNTDNTCCL1002 ) ","2023-12-20 23:01:29","DDL1784469832","Deduction","C6725457","","35.40","15168.31"
"1709","TCCL1002 - KUMAR CABLE NETWORK ( TNTDNTCCL1002 ) ","2023-12-20 23:01:29","DDL1784469837","Deduction","C6725457","","84.61","15083.7"
"1710","TCCL1002 - KUMAR CABLE NETWORK ( TNTDNTCCL1002 ) ","2023-12-20 23:01:29","DDL1784469847","Deduction","C1468096","","35.40","15048.3"
"1711","TCCL1002 - KUMAR CABLE NETWORK ( TNTDNTCCL1002 ) ","2023-12-20 23:01:29","DDL1784469852","Deduction","C1468096","","84.61","14963.69"
"1712","TCCL1002 - KUMAR CABLE NETWORK ( TNTDNTCCL1002 ) ","2023-12-20 23:01:29","DDL1784469857","Deduction","C3341959","","35.40","14928.29"
"1713","TCCL1002 - KUMAR CABLE NETWORK ( TNTDNTCCL1002 ) ","2023-12-20 23:01:29","DDL1784469862","Deduction","C3341959","","84.61","14843.68"
"1714","TCCL1002 - KUMAR CABLE NETWORK ( TNTDNTCCL1002 ) ","2023-12-20 23:01:29","DDL1784469872","Deduction","C4083997","","35.40","14808.28"
"1715","TCCL1002 - KUMAR CABLE NETWORK ( TNTDNTCCL1002 ) ","2023-12-20 23:01:29","DDL1784469877","Deduction","C4083997","","84.61","14723.67"
"1716","TCCL1002 - KUMAR CABLE NETWORK ( TNTDNTCCL1002 ) ","2023-12-20 23:01:29","DDL1784469882","Deduction","C3066959","","35.40","14688.27"
"1717","TCCL1002 - KUMAR CABLE NETWORK ( TNTDNTCCL1002 ) ","2023-12-20 23:01:29","DDL1784469887","Deduction","C3066959","","124.60","14563.67"
"1718","TCCL1002 - KUMAR CABLE NETWORK ( TNTDNTCCL1002 ) ","2023-12-20 23:01:29","DDL1784469892","Deduction","C1448873","","35.40","14528.27"
"1719","TCCL1002 - KUMAR CABLE NETWORK ( TNTDNTCCL1002 ) ","2023-12-20 23:01:29","DDL1784469897","Deduction","C1448873","","84.61","14443.66"
"1720","TCCL1002 - KUMAR CABLE NETWORK ( TNTDNTCCL1002 ) ","2023-12-20 23:01:29","DDL1784469902","Deduction","C2112697","","35.40","14408.26"
"1721","TCCL1002 - KUMAR CABLE NETWORK ( TNTDNTCCL1002 ) ","2023-12-20 23:01:29","DDL1784469912","Deduction","C2112697","","84.61","14323.65"
"1722","TCCL1002 - KUMAR CABLE NETWORK ( TNTDNTCCL1002 ) ","2023-12-20 23:01:29","DDL1784469922","Deduction","C8122307","","35.40","14288.25"
"1723","TCCL1002 - KUMAR CABLE NETWORK ( TNTDNTCCL1002 ) ","2023-12-20 23:01:29","DDL1784469927","Deduction","C8122307","","84.61","14203.64"
"1724","TCCL1002 - KUMAR CABLE NETWORK ( TNTDNTCCL1002 ) ","2023-12-20 23:01:29","DDL1784469937","Deduction","C8151612","","35.40","14168.24"
"1725","TCCL1002 - KUMAR CABLE NETWORK ( TNTDNTCCL1002 ) ","2023-12-20 23:01:29","DDL1784469942","Deduction","C8151612","","84.61","14083.63"
"1726","TCCL1002 - KUMAR CABLE NETWORK ( TNTDNTCCL1002 ) ","2023-12-20 23:01:29","DDL1784469947","Deduction","C1496001","","35.40","14048.23"
"1727","TCCL1002 - KUMAR CABLE NETWORK ( TNTDNTCCL1002 ) ","2023-12-20 23:01:29","DDL1784469952","Deduction","C1496001","","84.61","13963.62"
"1728","TCCL1002 - KUMAR CABLE NETWORK ( TNTDNTCCL1002 ) ","2023-12-20 23:01:30","DDL1784469962","Deduction","C2361951","","35.40","13928.22"
"1729","TCCL1002 - KUMAR CABLE NETWORK ( TNTDNTCCL1002 ) ","2023-12-20 23:01:30","DDL1784469967","Deduction","C2361951","","84.61","13843.61"
"1730","TCCL1002 - KUMAR CABLE NETWORK ( TNTDNTCCL1002 ) ","2023-12-20 23:01:30","DDL1784469977","Deduction","C1554616","","35.40","13808.21"
"1731","TCCL1002 - KUMAR CABLE NETWORK ( TNTDNTCCL1002 ) ","2023-12-20 23:01:30","DDL1784469982","Deduction","C1554616","","84.61","13723.6"
"1732","TCCL1002 - KUMAR CABLE NETWORK ( TNTDNTCCL1002 ) ","2023-12-20 23:01:30","DDL1784469992","Deduction","C1449005","","35.40","13688.2"
"1733","TCCL1002 - KUMAR CABLE NETWORK ( TNTDNTCCL1002 ) ","2023-12-20 23:01:30","DDL1784469997","Deduction","C1449005","","84.61","13603.59"
"1734","TCCL1002 - KUMAR CABLE NETWORK ( TNTDNTCCL1002 ) ","2023-12-20 23:01:30","DDL1784470007","Deduction","C7419138","","35.40","13568.19"
"1735","TCCL1002 - KUMAR CABLE NETWORK ( TNTDNTCCL1002 ) ","2023-12-20 23:01:30","DDL1784470012","Deduction","C7419138","","84.61","13483.58"
"1736","TCCL1002 - KUMAR CABLE NETWORK ( TNTDNTCCL1002 ) ","2023-12-20 23:01:30","DDL1784470027","Deduction","C1291193","","35.40","13448.18"
"1737","TCCL1002 - KUMAR CABLE NETWORK ( TNTDNTCCL1002 ) ","2023-12-20 23:01:30","DDL1784470032","Deduction","C1291193","","84.61","13363.57"
"1738","TCCL1002 - KUMAR CABLE NETWORK ( TNTDNTCCL1002 ) ","2023-12-20 23:01:30","DDL1784470052","Deduction","C7346395","","35.40","13328.17"
"1739","TCCL1002 - KUMAR CABLE NETWORK ( TNTDNTCCL1002 ) ","2023-12-20 23:01:30","DDL1784470057","Deduction","C7346395","","84.61","13243.56"
"1740","TCCL1002 - KUMAR CABLE NETWORK ( TNTDNTCCL1002 ) ","2023-12-20 23:01:30","DDL1784470077","Deduction","C9246684","","35.40","13208.16"
"1741","TCCL1002 - KUMAR CABLE NETWORK ( TNTDNTCCL1002 ) ","2023-12-20 23:01:30","DDL1784470082","Deduction","C9246684","","84.61","13123.55"
"1742","TCCL1002 - KUMAR CABLE NETWORK ( TNTDNTCCL1002 ) ","2023-12-20 23:01:30","DDL1784470087","Deduction","C2051430","","35.40","13088.15"
"1743","TCCL1002 - KUMAR CABLE NETWORK ( TNTDNTCCL1002 ) ","2023-12-20 23:01:30","DDL1784470092","Deduction","C2051430","","84.61","13003.54"
"1744","TCCL1002 - KUMAR CABLE NETWORK ( TNTDNTCCL1002 ) ","2023-12-20 23:01:30","DDL1784470097","Deduction","C1495997","","35.40","12968.14"
"1745","TCCL1002 - KUMAR CABLE NETWORK ( TNTDNTCCL1002 ) ","2023-12-20 23:01:30","DDL1784470102","Deduction","C1495997","","84.61","12883.53"
"1746","TCCL1002 - KUMAR CABLE NETWORK ( TNTDNTCCL1002 ) ","2023-12-20 23:01:30","DDL1784470112","Deduction","C0912432","","35.40","12848.13"
"1747","TCCL1002 - KUMAR CABLE NETWORK ( TNTDNTCCL1002 ) ","2023-12-20 23:01:30","DDL1784470122","Deduction","C0912432","","84.61","12763.52"
"1748","TCCL1002 - KUMAR CABLE NETWORK ( TNTDNTCCL1002 ) ","2023-12-20 23:01:30","DDL1784470137","Deduction","C12335179","","35.40","12728.12"
"1749","TCCL1002 - KUMAR CABLE NETWORK ( TNTDNTCCL1002 ) ","2023-12-20 23:01:30","DDL1784470142","Deduction","C12335179","","84.61","12643.51"
"1750","TCCL1002 - KUMAR CABLE NETWORK ( TNTDNTCCL1002 ) ","2023-12-20 23:01:30","DDL1784470152","Deduction","C2253859","","35.40","12608.11"
"1751","TCCL1002 - KUMAR CABLE NETWORK ( TNTDNTCCL1002 ) ","2023-12-20 23:01:30","DDL1784470157","Deduction","C2253859","","84.61","12523.5"
"1752","TCCL1002 - KUMAR CABLE NETWORK ( TNTDNTCCL1002 ) ","2023-12-20 23:01:30","DDL1784470167","Deduction","C3913039","","35.40","12488.1"
"1753","TCCL1002 - KUMAR CABLE NETWORK ( TNTDNTCCL1002 ) ","2023-12-20 23:01:30","DDL1784470172","Deduction","C3913039","","84.61","12403.49"
"1754","TCCL1002 - KUMAR CABLE NETWORK ( TNTDNTCCL1002 ) ","2023-12-20 23:01:30","DDL1784470187","Deduction","C1427096","","35.40","12368.09"
"1755","TCCL1002 - KUMAR CABLE NETWORK ( TNTDNTCCL1002 ) ","2023-12-20 23:01:30","DDL1784470192","Deduction","C1427096","","84.61","12283.48"
"1756","TCCL1002 - KUMAR CABLE NETWORK ( TNTDNTCCL1002 ) ","2023-12-20 23:01:30","DDL1784470202","Deduction","C1291197","","35.40","12248.08"
"1757","TCCL1002 - KUMAR CABLE NETWORK ( TNTDNTCCL1002 ) ","2023-12-20 23:01:30","DDL1784470207","Deduction","C1291197","","84.61","12163.47"
"1758","TCCL1002 - KUMAR CABLE NETWORK ( TNTDNTCCL1002 ) ","2023-12-20 23:01:30","DDL1784470217","Deduction","C1101626","","35.40","12128.07"
"1759","TCCL1002 - KUMAR CABLE NETWORK ( TNTDNTCCL1002 ) ","2023-12-20 23:01:31","DDL1784470222","Deduction","C1101626","","84.61","12043.46"
"1760","TCCL1002 - KUMAR CABLE NETWORK ( TNTDNTCCL1002 ) ","2023-12-20 23:01:31","DDL1784470232","Deduction","C1426504","","35.40","12008.06"
"1761","TCCL1002 - KUMAR CABLE NETWORK ( TNTDNTCCL1002 ) ","2023-12-20 23:01:31","DDL1784470237","Deduction","C1426504","","84.61","11923.45"
"1762","TCCL1002 - KUMAR CABLE NETWORK ( TNTDNTCCL1002 ) ","2023-12-20 23:01:31","DDL1784470247","Deduction","C0798159","","35.40","11888.05"
"1763","TCCL1002 - KUMAR CABLE NETWORK ( TNTDNTCCL1002 ) ","2023-12-20 23:01:31","DDL1784470252","Deduction","C0798159","","84.61","11803.44"
"1764","TCCL1002 - KUMAR CABLE NETWORK ( TNTDNTCCL1002 ) ","2023-12-20 23:01:31","DDL1784470262","Deduction","C2558743","","35.40","11768.04"
"1765","TCCL1002 - KUMAR CABLE NETWORK ( TNTDNTCCL1002 ) ","2023-12-20 23:01:31","DDL1784470267","Deduction","C2558743","","84.61","11683.43"
"1766","TCCL1002 - KUMAR CABLE NETWORK ( TNTDNTCCL1002 ) ","2023-12-20 23:01:31","DDL1784470282","Deduction","C5143534","","35.40","11648.03"
"1767","TCCL1002 - KUMAR CABLE NETWORK ( TNTDNTCCL1002 ) ","2023-12-20 23:01:31","DDL1784470287","Deduction","C5143534","","84.61","11563.42"
"1768","TCCL1002 - KUMAR CABLE NETWORK ( TNTDNTCCL1002 ) ","2023-12-20 23:01:31","DDL1784470292","Deduction","C1554067","","35.40","11528.02"
"1769","TCCL1002 - KUMAR CABLE NETWORK ( TNTDNTCCL1002 ) ","2023-12-20 23:01:31","DDL1784470302","Deduction","C1554067","","84.61","11443.41"
"1770","TCCL1002 - KUMAR CABLE NETWORK ( TNTDNTCCL1002 ) ","2023-12-20 23:01:31","DDL1784470317","Deduction","C0912367","","35.40","11408.01"
"1771","TCCL1002 - KUMAR CABLE NETWORK ( TNTDNTCCL1002 ) ","2023-12-20 23:01:31","DDL1784470322","Deduction","C0912367","","84.61","11323.4"
"1772","TCCL1002 - KUMAR CABLE NETWORK ( TNTDNTCCL1002 ) ","2023-12-20 23:01:31","DDL1784470337","Deduction","C4810648","","35.40","11288"
"1773","TCCL1002 - KUMAR CABLE NETWORK ( TNTDNTCCL1002 ) ","2023-12-20 23:01:31","DDL1784470342","Deduction","C4810648","","84.61","11203.39"
"1774","TCCL1002 - KUMAR CABLE NETWORK ( TNTDNTCCL1002 ) ","2023-12-20 23:01:31","DDL1784470357","Deduction","C10956878","","35.40","11167.99"
"1775","TCCL1002 - KUMAR CABLE NETWORK ( TNTDNTCCL1002 ) ","2023-12-20 23:01:31","DDL1784470362","Deduction","C10956878","","84.61","11083.38"
"1776","TCCL1002 - KUMAR CABLE NETWORK ( TNTDNTCCL1002 ) ","2023-12-20 23:01:31","DDL1784470372","Deduction","C1554611","","35.40","11047.98"
"1777","TCCL1002 - KUMAR CABLE NETWORK ( TNTDNTCCL1002 ) ","2023-12-20 23:01:31","DDL1784470377","Deduction","C1554611","","84.61","10963.37"
"1778","TCCL1002 - KUMAR CABLE NETWORK ( TNTDNTCCL1002 ) ","2023-12-20 23:01:31","DDL1784470392","Deduction","C1432096","","35.40","10927.97"
"1779","TCCL1002 - KUMAR CABLE NETWORK ( TNTDNTCCL1002 ) ","2023-12-20 23:01:31","DDL1784470397","Deduction","C1432096","","84.61","10843.36"
"1780","TCCL1002 - KUMAR CABLE NETWORK ( TNTDNTCCL1002 ) ","2023-12-20 23:01:31","DDL1784470407","Deduction","C1437289","","35.40","10807.96"
"1781","TCCL1002 - KUMAR CABLE NETWORK ( TNTDNTCCL1002 ) ","2023-12-20 23:01:31","DDL1784470412","Deduction","C1437289","","84.61","10723.35"
"1782","TCCL1002 - KUMAR CABLE NETWORK ( TNTDNTCCL1002 ) ","2023-12-20 23:01:31","DDL1784470432","Deduction","C2149901","","35.40","10687.95"
"1783","TCCL1002 - KUMAR CABLE NETWORK ( TNTDNTCCL1002 ) ","2023-12-20 23:01:31","DDL1784470437","Deduction","C2149901","","84.61","10603.34"
"1784","TCCL1002 - KUMAR CABLE NETWORK ( TNTDNTCCL1002 ) ","2023-12-20 23:01:31","DDL1784470457","Deduction","C0777090","","35.40","10567.94"
"1785","TCCL1002 - KUMAR CABLE NETWORK ( TNTDNTCCL1002 ) ","2023-12-20 23:01:31","DDL1784470462","Deduction","C0777090","","84.61","10483.33"
"1786","TCCL1002 - KUMAR CABLE NETWORK ( TNTDNTCCL1002 ) ","2023-12-20 23:01:31","DDL1784470477","Deduction","C1437320","","35.40","10447.93"
"1787","TCCL1002 - KUMAR CABLE NETWORK ( TNTDNTCCL1002 ) ","2023-12-20 23:01:31","DDL1784470482","Deduction","C1437320","","84.61","10363.32"
"1788","TCCL1002 - KUMAR CABLE NETWORK ( TNTDNTCCL1002 ) ","2023-12-20 23:01:31","DDL1784470507","Deduction","C1425806","","35.40","10327.92"
"1789","TCCL1002 - KUMAR CABLE NETWORK ( TNTDNTCCL1002 ) ","2023-12-20 23:01:31","DDL1784470512","Deduction","C1425806","","84.61","10243.31"
"1790","TCCL1002 - KUMAR CABLE NETWORK ( TNTDNTCCL1002 ) ","2023-12-20 23:01:31","DDL1784470517","Deduction","C0756480","","35.40","10207.91"
"1791","TCCL1002 - KUMAR CABLE NETWORK ( TNTDNTCCL1002 ) ","2023-12-20 23:01:31","DDL1784470522","Deduction","C0756480","","84.61","10123.3"
"1792","TCCL1002 - KUMAR CABLE NETWORK ( TNTDNTCCL1002 ) ","2023-12-20 23:01:32","DDL1784470547","Deduction","C0839779","","35.40","10087.9"
"1793","TCCL1002 - KUMAR CABLE NETWORK ( TNTDNTCCL1002 ) ","2023-12-20 23:01:32","DDL1784470552","Deduction","C0839779","","84.61","10003.29"
"1794","TCCL1002 - KUMAR CABLE NETWORK ( TNTDNTCCL1002 ) ","2023-12-20 23:01:32","DDL1784470572","Deduction","C1449004","","35.40","9967.89"
"1795","TCCL1002 - KUMAR CABLE NETWORK ( TNTDNTCCL1002 ) ","2023-12-20 23:01:32","DDL1784470577","Deduction","C1449004","","84.61","9883.28"
"1796","TCCL1002 - KUMAR CABLE NETWORK ( TNTDNTCCL1002 ) ","2023-12-20 23:01:32","DDL1784470597","Deduction","C2266457","","35.40","9847.88"
"1797","TCCL1002 - KUMAR CABLE NETWORK ( TNTDNTCCL1002 ) ","2023-12-20 23:01:32","DDL1784470602","Deduction","C2266457","","84.61","9763.27"
"1798","TCCL1002 - KUMAR CABLE NETWORK ( TNTDNTCCL1002 ) ","2023-12-20 23:01:32","DDL1784470612","Deduction","C5527136","","35.40","9727.87"
"1799","TCCL1002 - KUMAR CABLE NETWORK ( TNTDNTCCL1002 ) ","2023-12-20 23:01:32","DDL1784470617","Deduction","C5527136","","84.61","9643.26"
"1800","TCCL1002 - KUMAR CABLE NETWORK ( TNTDNTCCL1002 ) ","2023-12-20 23:01:32","DDL1784470632","Deduction","C1267818","","35.40","9607.86"
"1801","TCCL1002 - KUMAR CABLE NETWORK ( TNTDNTCCL1002 ) ","2023-12-20 23:01:32","DDL1784470637","Deduction","C1267818","","84.61","9523.25"
"1802","TCCL1002 - KUMAR CABLE NETWORK ( TNTDNTCCL1002 ) ","2023-12-20 23:01:32","DDL1784470662","Deduction","C10349797","","35.40","9487.85"
"1803","TCCL1002 - KUMAR CABLE NETWORK ( TNTDNTCCL1002 ) ","2023-12-20 23:01:32","DDL1784470667","Deduction","C10349797","","84.61","9403.24"
"1804","TCCL1002 - KUMAR CABLE NETWORK ( TNTDNTCCL1002 ) ","2023-12-20 23:01:32","DDL1784470682","Deduction","C0797263","","35.40","9367.84"
"1805","TCCL1002 - KUMAR CABLE NETWORK ( TNTDNTCCL1002 ) ","2023-12-20 23:01:32","DDL1784470687","Deduction","C0797263","","84.61","9283.23"
"1806","TCCL1002 - KUMAR CABLE NETWORK ( TNTDNTCCL1002 ) ","2023-12-20 23:01:32","DDL1784470697","Deduction","C7787231","","35.40","9247.83"
"1807","TCCL1002 - KUMAR CABLE NETWORK ( TNTDNTCCL1002 ) ","2023-12-20 23:01:32","DDL1784470702","Deduction","C7787231","","84.61","9163.22"
"1808","TCCL1002 - KUMAR CABLE NETWORK ( TNTDNTCCL1002 ) ","2023-12-20 23:01:32","DDL1784470727","Deduction","C5271559","","35.40","9127.82"
"1809","TCCL1002 - KUMAR CABLE NETWORK ( TNTDNTCCL1002 ) ","2023-12-20 23:01:32","DDL1784470732","Deduction","C5271559","","84.61","9043.21"
"1810","TCCL1002 - KUMAR CABLE NETWORK ( TNTDNTCCL1002 ) ","2023-12-20 23:01:32","DDL1784470747","Deduction","C0839942","","35.40","9007.81"
"1811","TCCL1002 - KUMAR CABLE NETWORK ( TNTDNTCCL1002 ) ","2023-12-20 23:01:32","DDL1784470752","Deduction","C0839942","","84.61","8923.2"
"1812","TCCL1002 - KUMAR CABLE NETWORK ( TNTDNTCCL1002 ) ","2023-12-20 23:01:32","DDL1784470762","Deduction","C1425740","","35.40","8887.8"
"1813","TCCL1002 - KUMAR CABLE NETWORK ( TNTDNTCCL1002 ) ","2023-12-20 23:01:32","DDL1784470767","Deduction","C1425740","","84.61","8803.19"
"1814","TCCL1002 - KUMAR CABLE NETWORK ( TNTDNTCCL1002 ) ","2023-12-20 23:01:32","DDL1784470782","Deduction","C0839767","","35.40","8767.79"
"1815","TCCL1002 - KUMAR CABLE NETWORK ( TNTDNTCCL1002 ) ","2023-12-20 23:01:32","DDL1784470787","Deduction","C0839767","","84.61","8683.18"
"1816","TCCL1002 - KUMAR CABLE NETWORK ( TNTDNTCCL1002 ) ","2023-12-20 23:01:32","DDL1784470797","Deduction","C2957470","","35.40","8647.78"
"1817","TCCL1002 - KUMAR CABLE NETWORK ( TNTDNTCCL1002 ) ","2023-12-20 23:01:32","DDL1784470802","Deduction","C2957470","","84.61","8563.17"
"1818","TCCL1002 - KUMAR CABLE NETWORK ( TNTDNTCCL1002 ) ","2023-12-20 23:01:32","DDL1784470817","Deduction","C6843192","","35.40","8527.77"
"1819","TCCL1002 - KUMAR CABLE NETWORK ( TNTDNTCCL1002 ) ","2023-12-20 23:01:32","DDL1784470822","Deduction","C6843192","","84.61","8443.16"
"1820","TCCL1002 - KUMAR CABLE NETWORK ( TNTDNTCCL1002 ) ","2023-12-20 23:01:32","DDL1784470842","Deduction","C2311055","","35.40","8407.76"
"1821","TCCL1002 - KUMAR CABLE NETWORK ( TNTDNTCCL1002 ) ","2023-12-20 23:01:32","DDL1784470847","Deduction","C2311055","","47.78","8359.98"
"1822","TCCL1002 - KUMAR CABLE NETWORK ( TNTDNTCCL1002 ) ","2023-12-20 23:01:32","DDL1784470872","Deduction","C1291195","","35.40","8324.58"
"1823","TCCL1002 - KUMAR CABLE NETWORK ( TNTDNTCCL1002 ) ","2023-12-20 23:01:33","DDL1784470877","Deduction","C1291195","","84.61","8239.97"
"1824","TCCL1002 - KUMAR CABLE NETWORK ( TNTDNTCCL1002 ) ","2023-12-20 23:01:33","DDL1784470882","Deduction","C0839950","","35.40","8204.57"
"1825","TCCL1002 - KUMAR CABLE NETWORK ( TNTDNTCCL1002 ) ","2023-12-20 23:01:33","DDL1784470887","Deduction","C0839950","","84.61","8119.96"
"1826","TCCL1002 - KUMAR CABLE NETWORK ( TNTDNTCCL1002 ) ","2023-12-20 23:01:33","DDL1784470897","Deduction","C2103869","","35.40","8084.56"
"1827","TCCL1002 - KUMAR CABLE NETWORK ( TNTDNTCCL1002 ) ","2023-12-20 23:01:33","DDL1784470902","Deduction","C2103869","","84.61","7999.95"
"1828","TCCL1002 - KUMAR CABLE NETWORK ( TNTDNTCCL1002 ) ","2023-12-20 23:01:33","DDL1784470917","Deduction","C6096709","","35.40","7964.55"
"1829","TCCL1002 - KUMAR CABLE NETWORK ( TNTDNTCCL1002 ) ","2023-12-20 23:01:33","DDL1784470922","Deduction","C6096709","","84.61","7879.94"
"1830","TCCL1002 - KUMAR CABLE NETWORK ( TNTDNTCCL1002 ) ","2023-12-20 23:01:33","DDL1784470947","Deduction","C10743576","","35.40","7844.54"
"1831","TCCL1002 - KUMAR CABLE NETWORK ( TNTDNTCCL1002 ) ","2023-12-20 23:01:33","DDL1784470952","Deduction","C10743576","","84.61","7759.93"
"1832","TCCL1002 - KUMAR CABLE NETWORK ( TNTDNTCCL1002 ) ","2023-12-20 23:01:33","DDL1784470962","Deduction","C2113643","","35.40","7724.53"
"1833","TCCL1002 - KUMAR CABLE NETWORK ( TNTDNTCCL1002 ) ","2023-12-20 23:01:33","DDL1784470967","Deduction","C2113643","","84.61","7639.92"
"1834","TCCL1002 - KUMAR CABLE NETWORK ( TNTDNTCCL1002 ) ","2023-12-20 23:01:33","DDL1784470977","Deduction","C7795023","","35.40","7604.52"
"1835","TCCL1002 - KUMAR CABLE NETWORK ( TNTDNTCCL1002 ) ","2023-12-20 23:01:33","DDL1784470982","Deduction","C7795023","","84.61","7519.91"
"1836","TCCL1002 - KUMAR CABLE NETWORK ( TNTDNTCCL1002 ) ","2023-12-20 23:01:43","DDL1784473882","Deduction","C1014398","","35.40","7484.51"
"1837","TCCL1002 - KUMAR CABLE NETWORK ( TNTDNTCCL1002 ) ","2023-12-20 23:01:43","DDL1784473887","Deduction","C1014398","","164.79","7319.72"
"1838","TCCL1002 - KUMAR CABLE NETWORK ( TNTDNTCCL1002 ) ","2023-12-20 23:01:43","DDL1784473892","Deduction","C1014398","","47.78","7271.94"
"1839","TCCL1002 - KUMAR CABLE NETWORK ( TNTDNTCCL1002 ) ","2023-12-20 23:01:43","DDL1784473897","Deduction","C1014398","","6.38","7265.56"
"1840","TCCL1002 - KUMAR CABLE NETWORK ( TNTDNTCCL1002 ) ","2023-12-20 23:01:43","DDL1784473902","Deduction","C1014398","","0.11","7265.45"
"1841","TCCL1002 - KUMAR CABLE NETWORK ( TNTDNTCCL1002 ) ","2023-12-20 23:01:43","DDL1784473927","Deduction","C5092149","","35.40","7230.05"
"1842","TCCL1002 - KUMAR CABLE NETWORK ( TNTDNTCCL1002 ) ","2023-12-20 23:01:43","DDL1784473932","Deduction","C5092149","","84.61","7145.44"
"1843","TCCL1002 - KUMAR CABLE NETWORK ( TNTDNTCCL1002 ) ","2023-12-20 23:01:43","DDL1784473957","Deduction","C1495999","","35.40","7110.04"
"1844","TCCL1002 - KUMAR CABLE NETWORK ( TNTDNTCCL1002 ) ","2023-12-20 23:01:43","DDL1784473962","Deduction","C1495999","","84.61","7025.43"
"1845","TCCL1002 - KUMAR CABLE NETWORK ( TNTDNTCCL1002 ) ","2023-12-20 23:01:43","DDL1784473982","Deduction","C2551645","","35.40","6990.03"
"1846","TCCL1002 - KUMAR CABLE NETWORK ( TNTDNTCCL1002 ) ","2023-12-20 23:01:43","DDL1784473987","Deduction","C2551645","","84.61","6905.42"
"1847","TCCL1002 - KUMAR CABLE NETWORK ( TNTDNTCCL1002 ) ","2023-12-20 23:01:43","DDL1784474017","Deduction","C1425705","","35.40","6870.02"
"1848","TCCL1002 - KUMAR CABLE NETWORK ( TNTDNTCCL1002 ) ","2023-12-20 23:01:43","DDL1784474022","Deduction","C1425705","","84.61","6785.41"
"1849","TCCL1002 - KUMAR CABLE NETWORK ( TNTDNTCCL1002 ) ","2023-12-20 23:01:43","DDL1784474047","Deduction","C5994050","","35.40","6750.01"
"1850","TCCL1002 - KUMAR CABLE NETWORK ( TNTDNTCCL1002 ) ","2023-12-20 23:01:43","DDL1784474052","Deduction","C5994050","","84.61","6665.4"
"1851","TCCL1002 - KUMAR CABLE NETWORK ( TNTDNTCCL1002 ) ","2023-12-20 23:01:43","DDL1784474082","Deduction","C6063433","","35.40","6630"
"1852","TCCL1002 - KUMAR CABLE NETWORK ( TNTDNTCCL1002 ) ","2023-12-20 23:01:43","DDL1784474087","Deduction","C6063433","","84.61","6545.39"
"1853","TCCL1002 - KUMAR CABLE NETWORK ( TNTDNTCCL1002 ) ","2023-12-20 23:01:43","DDL1784474102","Deduction","C9927995","","35.40","6509.99"
"1854","TCCL1002 - KUMAR CABLE NETWORK ( TNTDNTCCL1002 ) ","2023-12-20 23:01:43","DDL1784474107","Deduction","C9927995","","84.61","6425.38"
"1855","TCCL1002 - KUMAR CABLE NETWORK ( TNTDNTCCL1002 ) ","2023-12-20 23:01:43","DDL1784474127","Deduction","C2566372","","35.40","6389.98"
"1856","TCCL1002 - KUMAR CABLE NETWORK ( TNTDNTCCL1002 ) ","2023-12-20 23:01:43","DDL1784474132","Deduction","C2566372","","84.61","6305.37"
"1857","TCCL1002 - KUMAR CABLE NETWORK ( TNTDNTCCL1002 ) ","2023-12-20 23:01:43","DDL1784474142","Deduction","C12157796","","35.40","6269.97"
"1858","TCCL1002 - KUMAR CABLE NETWORK ( TNTDNTCCL1002 ) ","2023-12-20 23:01:43","DDL1784474147","Deduction","C12157796","","84.61","6185.36"
"1859","TCCL1002 - KUMAR CABLE NETWORK ( TNTDNTCCL1002 ) ","2023-12-20 23:01:43","DDL1784474157","Deduction","C1495995","","35.40","6149.96"
"1860","TCCL1002 - KUMAR CABLE NETWORK ( TNTDNTCCL1002 ) ","2023-12-20 23:01:43","DDL1784474162","Deduction","C1495995","","84.61","6065.35"
"1861","TCCL1002 - KUMAR CABLE NETWORK ( TNTDNTCCL1002 ) ","2023-12-20 23:01:43","DDL1784474182","Deduction","C1430868","","35.40","6029.95"
"1862","TCCL1002 - KUMAR CABLE NETWORK ( TNTDNTCCL1002 ) ","2023-12-20 23:01:43","DDL1784474187","Deduction","C1430868","","84.61","5945.34"
"1863","TCCL1002 - KUMAR CABLE NETWORK ( TNTDNTCCL1002 ) ","2023-12-20 23:01:43","DDL1784474217","Deduction","C1554614","","35.40","5909.94"
"1864","TCCL1002 - KUMAR CABLE NETWORK ( TNTDNTCCL1002 ) ","2023-12-20 23:01:43","DDL1784474222","Deduction","C1554614","","84.61","5825.33"
"1865","TCCL1002 - KUMAR CABLE NETWORK ( TNTDNTCCL1002 ) ","2023-12-20 23:01:44","DDL1784474232","Deduction","C1237951","","35.40","5789.93"
"1866","TCCL1002 - KUMAR CABLE NETWORK ( TNTDNTCCL1002 ) ","2023-12-20 23:01:44","DDL1784474242","Deduction","C1237951","","84.61","5705.32"
"1867","TCCL1002 - KUMAR CABLE NETWORK ( TNTDNTCCL1002 ) ","2023-12-20 23:01:44","DDL1784474257","Deduction","C6115333","","35.40","5669.92"
"1868","TCCL1002 - KUMAR CABLE NETWORK ( TNTDNTCCL1002 ) ","2023-12-20 23:01:44","DDL1784474262","Deduction","C6115333","","84.61","5585.31"
"1869","TCCL1002 - KUMAR CABLE NETWORK ( TNTDNTCCL1002 ) ","2023-12-20 23:01:44","DDL1784474282","Deduction","C1238016","","35.40","5549.91"
"1870","TCCL1002 - KUMAR CABLE NETWORK ( TNTDNTCCL1002 ) ","2023-12-20 23:01:44","DDL1784474287","Deduction","C1238016","","84.61","5465.3"
"1871","TCCL1002 - KUMAR CABLE NETWORK ( TNTDNTCCL1002 ) ","2023-12-20 23:01:44","DDL1784474312","Deduction","C5076993","","35.40","5429.9"
"1872","TCCL1002 - KUMAR CABLE NETWORK ( TNTDNTCCL1002 ) ","2023-12-20 23:01:44","DDL1784474317","Deduction","C5076993","","84.61","5345.29"
"1873","TCCL1002 - KUMAR CABLE NETWORK ( TNTDNTCCL1002 ) ","2023-12-20 23:01:44","DDL1784474342","Deduction","C1432094","","35.40","5309.89"
"1874","TCCL1002 - KUMAR CABLE NETWORK ( TNTDNTCCL1002 ) ","2023-12-20 23:01:44","DDL1784474347","Deduction","C1432094","","84.61","5225.28"
"1875","TCCL1002 - KUMAR CABLE NETWORK ( TNTDNTCCL1002 ) ","2023-12-20 23:01:44","DDL1784474367","Deduction","C1448871","","35.40","5189.88"
"1876","TCCL1002 - KUMAR CABLE NETWORK ( TNTDNTCCL1002 ) ","2023-12-20 23:01:44","DDL1784474372","Deduction","C1448871","","84.61","5105.27"
"1877","TCCL1002 - KUMAR CABLE NETWORK ( TNTDNTCCL1002 ) ","2023-12-20 23:01:44","DDL1784474387","Deduction","C5945921","","35.40","5069.87"
"1878","TCCL1002 - KUMAR CABLE NETWORK ( TNTDNTCCL1002 ) ","2023-12-20 23:01:44","DDL1784474392","Deduction","C5945921","","84.61","4985.26"
"1879","TCCL1002 - KUMAR CABLE NETWORK ( TNTDNTCCL1002 ) ","2023-12-20 23:01:44","DDL1784474407","Deduction","C12157930","","35.40","4949.86"
"1880","TCCL1002 - KUMAR CABLE NETWORK ( TNTDNTCCL1002 ) ","2023-12-20 23:01:44","DDL1784474412","Deduction","C12157930","","84.61","4865.25"
"1881","TCCL1002 - KUMAR CABLE NETWORK ( TNTDNTCCL1002 ) ","2023-12-20 23:01:44","DDL1784474432","Deduction","C1676810","","35.40","4829.85"
"1882","TCCL1002 - KUMAR CABLE NETWORK ( TNTDNTCCL1002 ) ","2023-12-20 23:01:44","DDL1784474437","Deduction","C1676810","","84.61","4745.24"
"1883","TCCL1002 - KUMAR CABLE NETWORK ( TNTDNTCCL1002 ) ","2023-12-20 23:01:44","DDL1784474442","Deduction","C1291194","","35.40","4709.84"
"1884","TCCL1002 - KUMAR CABLE NETWORK ( TNTDNTCCL1002 ) ","2023-12-20 23:01:44","DDL1784474447","Deduction","C1291194","","84.61","4625.23"
"1885","TCCL1002 - KUMAR CABLE NETWORK ( TNTDNTCCL1002 ) ","2023-12-21 20:28:07","DDL1788390852","Deduction","C1468098","","22.84","4602.39"
"1886","TCCL1002 - KUMAR CABLE NETWORK ( TNTDNTCCL1002 ) ","2023-12-21 20:28:07","DDL1788390857","Deduction","C1468098","","54.59","4547.8"
"1887","TCCL1002 - KUMAR CABLE NETWORK ( TNTDNTCCL1002 ) ","2023-12-21 20:28:08","DDL1788390887","Deduction","C1468098","","12.56","4535.24"
"1888","TCCL1002 - KUMAR CABLE NETWORK ( TNTDNTCCL1002 ) ","2023-12-21 20:28:08","DDL1788390892","Deduction","C1468098","","30.03","4505.21"
"1889","TCCL1002 - KUMAR CABLE NETWORK ( TNTDNTCCL1002 ) ","2023-12-22 22:07:03","DDL1784469837","Deposit reversal through bill edit (TCCL CLASSIC SD Disconnection credit back for 01-12-2023 to 31-12-2023) ","","24.57","","4529.78"
"1890","TCCL1002 - KUMAR CABLE NETWORK ( TNTDNTCCL1002 ) ","2023-12-22 22:07:03","DDL1784469832","Deposit reversal through bill edit (Network Capacity Fee Disconnection credit back for 01-12-2023 to 31-12-2023) ","","10.28","","4540.06"
"1891","TCCL1002 - KUMAR CABLE NETWORK ( TNTDNTCCL1002 ) ","2023-12-22 22:08:04","DDL1784469822","Deposit reversal through bill edit (TCCL CLASSIC SD Disconnection credit back for 01-12-2023 to 31-12-2023) ","","24.57","","4564.63"
"1892","TCCL1002 - KUMAR CABLE NETWORK ( TNTDNTCCL1002 ) ","2023-12-22 22:08:04","DDL1784469817","Deposit reversal through bill edit (Network Capacity Fee Disconnection credit back for 01-12-2023 to 31-12-2023) ","","10.28","","4574.91"
"1893","TCCL1002 - KUMAR CABLE NETWORK ( TNTDNTCCL1002 ) ","2023-12-22 22:08:48","DDL1784468597","Deposit reversal through bill edit (TCCL CLASSIC SD Disconnection credit back for 01-12-2023 to 31-12-2023) ","","24.57","","4599.48"
"1894","TCCL1002 - KUMAR CABLE NETWORK ( TNTDNTCCL1002 ) ","2023-12-22 22:08:48","DDL1784468592","Deposit reversal through bill edit (Network Capacity Fee Disconnection credit back for 01-12-2023 to 31-12-2023) ","","10.28","","4609.76"
"1895","TCCL1002 - KUMAR CABLE NETWORK ( TNTDNTCCL1002 ) ","2023-12-22 22:10:17","DDL1790333284","Deduction","C8916676","","22.84","4586.92"
"1896","TCCL1002 - KUMAR CABLE NETWORK ( TNTDNTCCL1002 ) ","2023-12-22 22:10:17","DDL1790333289","Deduction","C8916676","","54.59","4532.33"
"1897","TCCL1002 - KUMAR CABLE NETWORK ( TNTDNTCCL1002 ) ","2023-12-22 22:10:17","DDL1790333369","Deduction","C8916676","","11.42","4520.91"
"1898","TCCL1002 - KUMAR CABLE NETWORK ( TNTDNTCCL1002 ) ","2023-12-22 22:10:17","DDL1790333374","Deduction","C8916676","","27.29","4493.62"
"1899","TCCL1002 - KUMAR CABLE NETWORK ( TNTDNTCCL1002 ) ","2023-12-22 22:13:42","DDL1784469497","Deposit reversal through bill edit (TCCL CLASSIC SD Disconnection credit back for 01-12-2023 to 31-12-2023) ","","24.57","","4518.19"
"1900","TCCL1002 - KUMAR CABLE NETWORK ( TNTDNTCCL1002 ) ","2023-12-22 22:13:42","DDL1784469492","Deposit reversal through bill edit (Network Capacity Fee Disconnection credit back for 01-12-2023 to 31-12-2023) ","","10.28","","4528.47"
"1901","TCCL1002 - KUMAR CABLE NETWORK ( TNTDNTCCL1002 ) ","2023-12-24 09:45:31","DDL1792419528","Deduction","C1459352","","9.14","4519.33"
"1902","TCCL1002 - KUMAR CABLE NETWORK ( TNTDNTCCL1002 ) ","2023-12-24 09:45:31","DDL1792419543","Deduction","C1459352","","21.82","4497.51"
"1903","TCCL1002 - KUMAR CABLE NETWORK ( TNTDNTCCL1002 ) ","2023-12-24 10:15:09","DDL1792450404","Deduction","C3896312","","9.14","4488.37"
"1904","TCCL1002 - KUMAR CABLE NETWORK ( TNTDNTCCL1002 ) ","2023-12-24 10:15:09","DDL1792450409","Deduction","C3896312","","21.82","4466.55"
"1905","TCCL1002 - KUMAR CABLE NETWORK ( TNTDNTCCL1002 ) ","2023-12-24 11:31:24","DDL1792550031","Deduction","C13029091","","9.14","4457.41"
"1906","TCCL1002 - KUMAR CABLE NETWORK ( TNTDNTCCL1002 ) ","2023-12-24 11:31:24","DDL1792550036","Deduction","C13029091","","21.82","4435.59"
"1907","TCCL1002 - KUMAR CABLE NETWORK ( TNTDNTCCL1002 ) ","2023-12-24 13:05:49","DDL1792660065","Deduction","C1448515","","9.14","4426.45"
"1908","TCCL1002 - KUMAR CABLE NETWORK ( TNTDNTCCL1002 ) ","2023-12-24 13:05:49","DDL1792660070","Deduction","C1448515","","19.25","4407.2"
"1909","TCCL1002 - KUMAR CABLE NETWORK ( TNTDNTCCL1002 ) ","2023-12-24 13:05:49","DDL1792660075","Deduction","C1448515","","23.60","4383.6"
"1910","TCCL1002 - KUMAR CABLE NETWORK ( TNTDNTCCL1002 ) ","2023-12-24 13:05:49","DDL1792660080","Deduction","C1448515","","49.72","4333.88"
"1911","TCCL1002 - KUMAR CABLE NETWORK ( TNTDNTCCL1002 ) ","2023-12-28 22:27:43","DDL1784470687","Deposit reversal through bill edit (TCCL CLASSIC SD Disconnection credit back for 01-12-2023 to 31-12-2023) ","","8.19","","4342.07"
"1912","TCCL1002 - KUMAR CABLE NETWORK ( TNTDNTCCL1002 ) ","2023-12-28 22:27:43","DDL1784470682","Deposit reversal through bill edit (Network Capacity Fee Disconnection credit back for 01-12-2023 to 31-12-2023) ","","3.42","","4345.49"
"1913","TCCL1002 - KUMAR CABLE NETWORK ( TNTDNTCCL1002 ) ","2023-12-28 22:30:44","DDL1784470222","Deposit reversal through bill edit (TCCL CLASSIC SD Disconnection credit back for 01-12-2023 to 31-12-2023) ","","8.19","","4353.68"
"1914","TCCL1002 - KUMAR CABLE NETWORK ( TNTDNTCCL1002 ) ","2023-12-28 22:30:45","DDL1784470217","Deposit reversal through bill edit (Network Capacity Fee Disconnection credit back for 01-12-2023 to 31-12-2023) ","","3.42","","4357.1"
"1915","TCCL1002 - KUMAR CABLE NETWORK ( TNTDNTCCL1002 ) ","2023-12-29 07:49:37","DDL1798329615","Deduction","C6287282","","17.13","4339.97"
"1916","TCCL1002 - KUMAR CABLE NETWORK ( TNTDNTCCL1002 ) ","2023-12-29 07:49:37","DDL1798329620","Deduction","C6287282","","40.94","4299.03"
"1917","TCCL1002 - KUMAR CABLE NETWORK ( TNTDNTCCL1002 ) ","2023-12-29 07:49:38","DDL1798329625","Deduction","C6287282","","3.43","4295.6"
"1918","TCCL1002 - KUMAR CABLE NETWORK ( TNTDNTCCL1002 ) ","2023-12-29 07:49:38","DDL1798329630","Deduction","C6287282","","8.20","4287.4"
"1919","TCCL1002 - KUMAR CABLE NETWORK ( TNTDNTCCL1002 ) ","2024-01-05 11:21:19","TR22748225","Adjustment (classic sd pack discount 168*5 dec 2023) ","","840.00","","5127.4"
